Daley Thompson's Olympic Challenge 1Disk	D/Daley Thompsons Olympic Ch	A-Games:D/DaleyThompsonsOC1Disk/DaleyThompsonsOC1Disk.Slave
Daley Thompson's Olympic Challenge 2Disk	D/Daley Thompsons Olympic V2	A-Games:D/DaleyThompsonsOC2Disk/DaleyThompsonsOC2Disk.Slave
Damocles - Mercenary II	D/Damocles - Mercenary II	A-Games:D/Damocles/Damocles.slave
Dan Dare III: The Escape	D/Dan Dare III The Escape	A-Games:D/DanDare3/DanDare3.slave
Dark Fusion	D/Dark Fusion	A-Games:D/DarkFusion/DarkFusion.Slave
Darkman	D/Darkman	A-Games:D/Darkman/Darkman.Slave
DarkSpyre	D/DarkSpyre	A-Games:D/DarkSpyre/DarkSpyre.Slave
Datastorm	D/Datastorm	A-Games:D/Datastorm/Datastorm.Slave
Days of Thunder	D/Days of Thunder	A-Games:D/DaysOfThunder/DaysOfThunder.Slave
Death Trap	D/Death Trap	A-Games:D/DeathTrap/DeathTrap.Slave
Deep, The	D/Deep. The	A-Games:D/Deep/Deep.Slave
Deep Space	D/Deep Space	A-Games:D/DeepSpace/DeepSpace.slave
Defender II	D/Defender II	A-Games:D/Defender2/Defender2.Slave
Defenders of the Earth	D/Defenders of the Earth	A-Games:D/DefendersOfTheEarth/DefendersOfTheEarth.slave
Deflektor	D/Deflektor	A-Games:D/Deflektor/Deflektor.slave
Demon Blue	D/Demon Blue	A-Games:D/DemonBlue/DemonBlue.slave
Denaris 1Disk	D/Denaris 1Disk	A-Games:D/Denaris1Disk/Denaris1Disk.Slave
Denaris 2Disk	D/Denaris 2Disk	A-Games:D/Denaris2Disk/Denaris2Disk.Slave
Devious Designs	D/Devious Designs	A-Games:D/DeviousDesigns/DeviousDesigns.Slave
Dick Tracy	D/Dick Tracy	A-Games:D/DickTracy/DickTracy.Slave
Die Hard 2: Die Harder	D/Die Hard 2 Die Harder	A-Games:D/DieHard2/DieHard2.Slave
Digger	D/Digger	A-Games:D/Digger/Digger.Slave
Dinosaur Detective Agency	D/Dinosaur Detective Agency	A-Games:D/DinosaurDetectiveAgency/DinosaurDetectiveAgency.Slave
Dino Wars	D/Dino Wars	A-Games:D/DinoWars/DinoWars.slave
Dino Wars DE	D/Dino Wars DE	A-Games:D/DinoWarsDe/DinoWarsDe.Slave
Discovery: In The Steps of Columbus	D/Discovery In The Steps of	A-Games:D/Discovery/Discovery.Slave
Ditris	D/Ditris	A-Games:D/Ditris/Ditris.Slave
Dizzy Collection Disk2	D/Dizzy Collection Disk2	A-Games:D/DizzyCollection/Disk2.Slave
Dizzy Dice	D/Dizzy Dice	A-Games:D/DizzyDice/DizzyDice.Slave
Dizzy Panic	D/Dizzy Panic	A-Games:D/DizzyPanic/DizzyPanic.slave
Dizzy's Excellent Adventures Disk1	D/Dizzys Excellent Adventure	A-Games:D/DizzysExcellentAdventures/Disk1.Slave
Dizzy's Excellent Adventures Disk2	D/Dizzys Excellent Advent V2	A-Games:D/DizzysExcellentAdventures/Disk2.Slave
Dogs of War	D/Dogs of War	A-Games:D/DogsOfWar/DogsOfWar.Slave
Dominator	D/Dominator	A-Games:D/Dominator/Dominator.slave
Donkey Kong	D/Donkey Kong	A-Games:D/DonkeyKong/DonkeyKong.slave
Doodlebug	D/Doodlebug	A-Games:D/Doodlebug/Doodlebug.slave
Doofus	D/Doofus	A-Games:D/Doofus/Doofus.Slave
Double Dragon	D/Double Dragon	A-Games:D/DoubleDragon/DoubleDragon.Slave
Double Dragon II: The Revenge	D/Double Dragon II The Reven	A-Games:D/DoubleDragon2/DoubleDragon2.Slave
Double Dragon II: The Revenge NTSC	D/Double Dragon II The Re V2	A-Games:D/DoubleDragon2NTSC/DoubleDragon2NTSC.Slave
Double Dragon 3: The Rosetta Stone	D/Double Dragon 3 The Rosett	A-Games:D/DoubleDragon3/DoubleDragon3.slave
Double Dribble	D/Double Dribble	A-Games:D/DoubleDribble/DoubleDribble.slave
Dragon Breed	D/Dragon Breed	A-Games:D/DragonBreed/DragonBreed.Slave
Dragonflight	D/Dragonflight	A-Games:D/Dragonflight/Dragonflight.Slave
Dragonflight DE	D/Dragonflight DE	A-Games:D/DragonflightDe/DragonflightDe.Slave
Dragonflight FR	D/Dragonflight FR	A-Games:D/DragonflightFr/DragonflightFr.Slave
DragonScape	D/DragonScape	A-Games:D/DragonScape/DragonScape.slave
Dragon's Kingdom Demo	D/Dragons Kingdom Demo	A-Games:D/DragonsKingdomDemo/DragonsKingdomDemo.Slave
Dragon's Lair II: Time Warp	D/Dragons Lair II Time Warp	A-Games:D/DragonsLair2/DragonsLair2.Slave
Dragon's Lair III: The Curse of Mordread	D/Dragons Lair III The Curse	A-Games:D/DragonsLair3/DragonsLair3.Slave
Dragon Spirit	D/Dragon Spirit	A-Games:D/DragonSpirit/DragonSpirit.Slave
Dragon Tiles	D/Dragon Tiles	A-Games:D/DragonTiles/DragonTiles.Slave
Drivin' Force	D/Drivin Force	A-Games:D/DrivinForce/DrivinForce.Slave
Dr. Mario	D/Dr. Mario	A-Games:D/DrMario/DrMario.slave
Dux	D/Dux	A-Games:D/Dux/Dux.Slave
Dyna Blaster	D/Dyna Blaster	A-Games:D/DynaBlaster/DynaBlaster.Slave
Dynamite Düx	D/Dynamite Dux	A-Games:D/DynamiteDux/DynamiteDux.Slave
Dynasty Wars	D/Dynasty Wars	A-Games:D/DynastyWars/DynastyWars.slave
Dyter-07	D/Dyter-07	A-Games:D/Dyter07/Dyter07.slave
Do! Run Run Files	D/Do Run Run Files	A-Games:M/MrDoRunRunFiles/MrDoRunRunFiles.Slave
Do! Run Run Image	D/Do Run Run Image	A-Games:M/MrDoRunRunImage/MrDoRunRunImage.Slave