The Adventures of Genlock Holmes	T/The Adventures of Genlock	A-Games:A/AdventuresOfGenlockHolmes/AdventuresOfGenlockHolmes.Slave
The Ancient Art of War in the Skies	T/The Ancient Art of War in	A-Games:A/AncientArtOfWarInTheSkies/AncientArtOfWarInTheSkies.Slave
The Attack of the Green Smelly Aliens From Planet 27b/6	T/The Attack of the Green Sm	A-Games:A/AotGSAFP27b6/AotGSAFP27b6.Slave
The Cartoons	T/The Cartoons	A-Games:C/Cartoons/Cartoons.Slave
The Clue! DE	T/The Clue DE	A-Games:C/ClouDe/ClouDe.Slave
The Clue! Profidisk DE	T/The Clue Profidisk DE	A-Games:C/ClouDe&Profidisk/ClouDe&Profidisk.Slave
Third Reich	T/Third Reich	A-Games:C/ComputerThirdReich/ComputerThirdReich.Slave
The First Samurai	T/The First Samurai	A-Games:F/FirstSamuraiA1200Version/FirstSamuraiA1200Version.Slave
The Four Crystals of Trazere getlegendsavedisk NTSC	T/The Four Crystals of Traze	A-Games:F/FourCrystalsOfTrazereNTSC/getlegendsavedisk.slave
The Four Crystals of Trazere NTSC	T/The Four Crystals of Tr V2	A-Games:F/FourCrystalsOfTrazereNTSC/FourCrystalsOfTrazereNTSC.Slave
The Games: Summer Edition	T/The Games Summer Edition	A-Games:G/GamesSummerEdition/GamesSummerEdition.Slave
The Games: Winter Edition	T/The Games Winter Edition	A-Games:G/GamesWinterEdition/GamesWinterEdition.Slave
The Great Giana Sisters Special Edition	T/The Great Giana Sisters Sp	A-Games:G/GianaSistersSE/GianaSistersSE.slave
The Hellrun Machine	T/The Hellrun Machine	A-Games:H/HellrunMachine/HellrunMachine.Slave
The Hitchhiker's Guide to the Galaxy	T/The Hitchhikers Guide to t	A-Games:H/HitchhikersGuideTTG/HitchhikersGuideTTG.Slave
The Hunt for Red October	T/The Hunt for Red October	A-Games:H/HuntForRedOctober/HuntForRedOctober.Slave
Templos Sagrados, Los ES	T/Templos Sagrados. Los ES	A-Games:L/LosTemplosSagradosEs/LosTemplosSagradosEs.slave
The North Sea Inferno	T/The North Sea Inferno	A-Games:N/NorthSeaInferno/NorthSeaInferno.Slave
The Paranoia Complex	T/The Paranoia Complex	A-Games:P/ParanoiaComplex/ParanoiaComplex.Slave
The Paranoia Complex DE	T/The Paranoia Complex DE	A-Games:P/ParanoiaComplexDe/ParanoiaComplexDe.Slave
The Quest For The Time-Bird Files	T/The Quest For The Time-Bir	A-Games:Q/QuestForTimeBirdFiles/QuestForTimeBirdFiles.Slave
The Quest For The Time-Bird Image	T/The Quest For The Time- V2	A-Games:Q/QuestForTimeBirdImage/QuestForTimeBirdImage.Slave
The Quest For The Time-Bird FR Files	T/The Quest For The Time- V3	A-Games:Q/QueteLOiseauDuTempFrFiles/QueteLOiseauDuTempFrFiles.Slave
The Quest For The Time-Bird FR Image	T/The Quest For The Time- V4	A-Games:Q/QueteLOiseauDuTempFrImage/QueteLOiseauDuTempFrImage.Slave
Table Tennis Simulation	T/Table Tennis Simulation	A-Games:T/TableTennisSimulation/TableTennisSimulation.Slave
Taekwondo	T/Taekwondo	A-Games:T/Taekwondo/Taekwondo.Slave
Take 'Em Out	T/Take Em Out	A-Games:T/TakeEmOut/TakeEmOut.slave
Tanglewood	T/Tanglewood	A-Games:T/Tanglewood/Tanglewood.Slave
Tangram	T/Tangram	A-Games:T/Tangram/Tangram.slave
Targhan	T/Targhan	A-Games:T/Targhan/Targhan.Slave
Targhan FAST	T/Targhan FAST	A-Games:T/TarghanFast/TarghanFast.slave
Targhan FR FAST	T/Targhan FR FAST	A-Games:T/TarghanFastFr/TarghanFastFr.slave
Targhan FR	T/Targhan FR	A-Games:T/TarghanFr/TarghanFr.Slave
Tass Times in Tonetown	T/Tass Times in Tonetown	A-Games:T/TassTimesInTonetown/TassTimesInTonetown.Slave
T-Bird	T/T-Bird	A-Games:T/TBird/TBird.Slave
Team Suzuki	T/Team Suzuki	A-Games:T/TeamSuzuki/TeamSuzuki.slave
Team Yankee	T/Team Yankee	A-Games:T/TeamYankee/TeamYankee.Slave
Tearaway Thomas	T/Tearaway Thomas	A-Games:T/TearawayThomas/TearawayThomas.slave
Tech	T/Tech	A-Games:T/Tech/Tech.Slave
TechnoCop	T/TechnoCop	A-Games:T/Technocop/Technocop.Slave
Technology 2	T/Technology 2	A-Games:T/Technology2/Technology2.Slave
Tecnoball	T/Tecnoball	A-Games:T/Tecnoball/Tecnoball.slave
Teenage Mutant Hero Turtles	T/Teenage Mutant Hero Turtle	A-Games:T/TeenageMtntHeroTurtles/TeenageMtntHeroTurtles.Slave
Teenage Mutant Hero Turtles	T/Teenage Mutant Hero Tur V2	A-Games:T/TeenageMtntHeroTurtlesCOp/TeenageMtntHeroTurtlesCOp.slave
Teenage Mutant Ninja Turtles	T/Teenage Mutant Ninja Turtl	A-Games:T/TeenageMtntNinjaTurtles/TeenageMtntNinjaTurtles.Slave
Teenage Queen	T/Teenage Queen	A-Games:T/TeenageQueen/TeenageQueen.Slave
Temple of Apshai Trilogy	T/Temple of Apshai Trilogy	A-Games:T/TempleOfApshaiTrilogy/TempleOfApshaiTrilogy.Slave
Tennis Champs	T/Tennis Champs	A-Games:T/TennisChamps/TennisChamps.Slave
Tennis Cup 1MB	T/Tennis Cup 1MB	A-Games:T/TennisCup1Mb/TennisCup1Mb.Slave
Tennis Cup FR 1MB	T/Tennis Cup FR 1MB	A-Games:T/TennisCup1MbFr/TennisCup1MbFr.Slave
Tennis Cup II	T/Tennis Cup II	A-Games:T/TennisCup2/TennisCup2.Slave
Tennis Cup 512KB	T/Tennis Cup 512KB	A-Games:T/TennisCup512Kb/TennisCup512Kb.Slave
Tennis Cup FR 512KB	T/Tennis Cup FR 512KB	A-Games:T/TennisCup512KbFr/TennisCup512KbFr.Slave
Tensai Demo	T/Tensai Demo	A-Games:T/TensaiDemo/TensaiDemo.Slave
T2: The Arcade Game	T/T2 The Arcade Game	A-Games:T/Terminator2Arcade/Terminator2Arcade.slave
Terminator 2: Judgment Day	T/Terminator 2 Judgment Day	A-Games:T/Terminator2JudgmentDay/Terminator2JudgmentDay.Slave
Terramex	T/Terramex	A-Games:T/Terramex/Terramex.Slave
Terrorpods	T/Terrorpods	A-Games:T/Terrorpods/Terrorpods.Slave
Terry's Big Adventure	T/Terrys Big Adventure	A-Games:T/TerrysBigAdventure/TerrysBigAdventure.Slave
Test Drive	T/Test Drive	A-Games:T/TestDrive/TestDrive.slave
Test Drive II: The Duel	T/Test Drive II The Duel	A-Games:T/TestDrive2/TestDrive2.slave
Test Drive II: The Duel DataDisk	T/Test Drive II The Duel Dat	A-Games:T/TestDrive2&DataDisks/TestDrive2&DataDisks.slave
Tetra Quest	T/Tetra Quest	A-Games:T/TetraQuest/TetraQuest.slave
Tetris	T/Tetris	A-Games:T/TetrisInfogrames/TetrisInfogrames.Slave
Tetris	T/Tetris 	A-Games:T/TetrisMirrorsoft/TetrisMirrorsoft.Slave
Tetris Pro	T/Tetris Pro	A-Games:T/TetrisPro/TetrisPro.Slave
Tetrix	T/Tetrix	A-Games:T/Tetrix/Tetrix.Slave
Theatre of Death	T/Theatre of Death	A-Games:T/TheatreOfDeath/TheatreOfDeath.Slave
Their Finest Hour: The Battle of Britain	T/Their Finest Hour The Batt	A-Games:T/TheirFinestHour/TheirFinestHour.Slave
Their Finest Hour: The Battle of Britain Missions	T/Their Finest Hour The B V2	A-Games:T/TheirFinestHour&Missions/TheirFinestHour&Missions.Slave
Theme Park	T/Theme Park	A-Games:T/ThemePark/ThemePark.Slave
Theme Park Mystery	T/Theme Park Mystery	A-Games:T/ThemeParkMystery/ThemeParkMystery.slave
Theme Park Mystery NTSC	T/Theme Park Mystery NTSC	A-Games:T/ThemeParkMysteryNTSC/ThemeParkMysteryNTSC.slave
Thexder	T/Thexder	A-Games:T/Thexder/Thexder.slave
Third Courier, The	T/Third Courier. The	A-Games:T/ThirdCourier/ThirdCourier.Slave
Thomas the Tank Engine	T/Thomas the Tank Engine	A-Games:T/ThomasTheTankEngine/ThomasTheTankEngine.Slave
Thomas the Tank Engine 2	T/Thomas the Tank Engine 2	A-Games:T/ThomasTheTankEngine2/ThomasTheTankEngine2.slave
Three Stooges, The NTSC	T/Three Stooges. The NTSC	A-Games:T/ThreeStoogesNTSC/ThreeStoogesNTSC.Slave
Thunderbirds	T/Thunderbirds	A-Games:T/Thunderbirds/Thunderbirds.slave
Thunder Blade	T/Thunder Blade	A-Games:T/ThunderBlade/ThunderBlade.Slave
Thunder Blade NTSC	T/Thunder Blade NTSC	A-Games:T/ThunderBladeNTSC/ThunderBladeNTSC.Slave
Thunderboy	T/Thunderboy	A-Games:T/ThunderBoy/ThunderBoy.Slave
Thunder Burner	T/Thunder Burner	A-Games:T/ThunderBurner/ThunderBurner.Slave
ThunderCats	T/ThunderCats	A-Games:T/ThunderCats/ThunderCats.slave
Thunderhawk AH-73M	T/Thunderhawk AH-73M	A-Games:T/ThunderHawkAH73M/ThunderHawkAH73M.Slave
Thunderhawk AH-73M DE	T/Thunderhawk AH-73M DE	A-Games:T/ThunderHawkAH73MDe/ThunderHawkAH73MDe.Slave
Thunderhawk AH-73M FR	T/Thunderhawk AH-73M FR	A-Games:T/ThunderHawkAH73MFr/ThunderHawkAH73MFr.Slave
Thunder Jaws	T/Thunder Jaws	A-Games:T/ThunderJaws/ThunderJaws.Slave
Thunderstrike	T/Thunderstrike	A-Games:T/ThunderStrike/ThunderStrike.slave
Tie-Break	T/Tie-Break	A-Games:T/TieBreak/TieBreak.Slave
Tiger Road	T/Tiger Road	A-Games:T/TigerRoad/TigerRoad.Slave
Time	T/Time	A-Games:T/Time/Time.Slave
Time and Magik	T/Time and Magik	A-Games:T/TimeAndMagik/TimeAndMagik.Slave
Time Bandit	T/Time Bandit	A-Games:T/TimeBandit/TimeBandit.slave
Time DE	T/Time DE	A-Games:T/TimeDe/TimeDe.Slave
Time FR	T/Time FR	A-Games:T/TimeFr/TimeFr.Slave
Time Lock	T/Time Lock	A-Games:T/TimeLock/TimeLock.slave
Time Machine	T/Time Machine	A-Games:T/TimeMachine/TimeMachine.slave
Time Race	T/Time Race	A-Games:T/TimeRace/TimeRace.Slave
Time Runners 01: Gateways in Time	T/Time Runners 01 Gateways i	A-Games:T/TimeRunners01/TimeRunners01.Slave
Time Runners 02: The Space Stone	T/Time Runners 02 The Space	A-Games:T/TimeRunners02/TimeRunners02.Slave
Time Runners 03: The Big Run	T/Time Runners 03 The Big Ru	A-Games:T/TimeRunners03/TimeRunners03.Slave
Time Runners 04: The Castle of Fear	T/Time Runners 04 The Castle	A-Games:T/TimeRunners04/TimeRunners04.Slave
Time Runners 05: The Black Knight	T/Time Runners 05 The Black	A-Games:T/TimeRunners05/TimeRunners05.Slave
Time Runners 06: The Bewitched Forest	T/Time Runners 06 The Bewitc	A-Games:T/TimeRunners06/TimeRunners06.Slave
Time Runners 07: In the Land of the Invaders	T/Time Runners 07 In the Lan	A-Games:T/TimeRunners07/TimeRunners07.Slave
Time Runners 08: The Impregnable Fortress	T/Time Runners 08 The Impreg	A-Games:T/TimeRunners08/TimeRunners08.Slave
Time Runners 09: The Time Demon	T/Time Runners 09 The Time D	A-Games:T/TimeRunners09/TimeRunners09.Slave
Time Runners 10: The Time Sentry	T/Time Runners 10 The Time S	A-Games:T/TimeRunners10/TimeRunners10.Slave
Time Runners 11: The Steel City	T/Time Runners 11 The Steel	A-Games:T/TimeRunners11/TimeRunners11.Slave
Time Runners 12: A Target for the Cyborg	T/Time Runners 12 A Target f	A-Games:T/TimeRunners12/TimeRunners12.Slave
Time Runners 13: Cyberkiller	T/Time Runners 13 Cyberkille	A-Games:T/TimeRunners13/TimeRunners13.Slave
Time Runners 14: Toraxid - War Star	T/Time Runners 14 Toraxid -	A-Games:T/TimeRunners14/TimeRunners14.Slave
Time Runners 15: At the Speed of Light	T/Time Runners 15 At the Spe	A-Games:T/TimeRunners15/TimeRunners15.Slave
Time Runners 16: The Galaxy Emperor	T/Time Runners 16 The Galaxy	A-Games:T/TimeRunners16/TimeRunners16.Slave
Time Runners 17: The Living Labyrinth	T/Time Runners 17 The Living	A-Games:T/TimeRunners17/TimeRunners17.Slave
Time Runners 18: The Killer Shadow	T/Time Runners 18 The Killer	A-Games:T/TimeRunners18/TimeRunners18.Slave
Time Runners 19: The Nightmare Prince	T/Time Runners 19 The Nightm	A-Games:T/TimeRunners19/TimeRunners19.Slave
Time Runners 20: The Mountains of Death	T/Time Runners 20 The Mounta	A-Games:T/TimeRunners20/TimeRunners20.Slave
Time Runners 21: The Black Dragon's Curse	T/Time Runners 21 The Black	A-Games:T/TimeRunners21/TimeRunners21.Slave
Time Runners 22: The Eternal Damned	T/Time Runners 22 The Eterna	A-Games:T/TimeRunners22/TimeRunners22.Slave
Time Runners 23: The Time Monarch	T/Time Runners 23 The Time M	A-Games:T/TimeRunners23/TimeRunners23.Slave
Time Runners 24: Beyond All Dimensions	T/Time Runners 24 Beyond All	A-Games:T/TimeRunners24/TimeRunners24.Slave
Time Runners 25: The Lost Planet Earth	T/Time Runners 25 The Lost P	A-Games:T/TimeRunners25/TimeRunners25.Slave
Time Runners 26: The Time Warrior	T/Time Runners 26 The Time W	A-Games:T/TimeRunners26/TimeRunners26.Slave
Time Runners 27: Red Night	T/Time Runners 27 Red Night	A-Games:T/TimeRunners27/TimeRunners27.Slave
Time Runners 28: Beyond the End	T/Time Runners 28 Beyond the	A-Games:T/TimeRunners28/TimeRunners28.Slave
Time Runners 29: The Last Revelation	T/Time Runners 29 The Last R	A-Games:T/TimeRunners29/TimeRunners29.Slave
Time Runners 30: The Final Duel	T/Time Runners 30 The Final	A-Games:T/TimeRunners30/TimeRunners30.Slave
Time Runners 30: The Final Duel TimeRunners30	T/Time Runners 30 The Final 	A-Games:T/TimeRunnersSeries/TimeRunners30.Slave
Time Runners 28: Beyond the End TimeRunners28	T/Time Runners 28 Beyond  V2	A-Games:T/TimeRunnersSeries/TimeRunners28.Slave
Time Runners 29: The Last Revelation TimeRunners29	T/Time Runners 29 The Las V2	A-Games:T/TimeRunnersSeries/TimeRunners29.Slave
Time Runners 27: Red Night TimeRunners27	T/Time Runners 27 Red Night 	A-Games:T/TimeRunnersSeries/TimeRunners27.Slave
Time Runners 25: The Lost Planet Earth TimeRunners25	T/Time Runners 25 The Los V2	A-Games:T/TimeRunnersSeries/TimeRunners25.Slave
Time Runners 26: The Time Warrior TimeRunners26	T/Time Runners 26 The Tim V2	A-Games:T/TimeRunnersSeries/TimeRunners26.Slave
Time Runners 24: Beyond All Dimensions TimeRunners24	T/Time Runners 24 Beyond  V2	A-Games:T/TimeRunnersSeries/TimeRunners24.Slave
Time Runners 22: The Eternal Damned TimeRunners22	T/Time Runners 22 The Ete V2	A-Games:T/TimeRunnersSeries/TimeRunners22.Slave
Time Runners 19: The Nightmare Prince TimeRunners19	T/Time Runners 19 The Nig V2	A-Games:T/TimeRunnersSeries/TimeRunners19.Slave
Time Runners 20: The Mountains of Death TimeRunners20	T/Time Runners 20 The Mou V2	A-Games:T/TimeRunnersSeries/TimeRunners20.Slave
Time Runners 21: The Black Dragon's Curse TimeRunners21	T/Time Runners 21 The Black 	A-Games:T/TimeRunnersSeries/TimeRunners21.Slave
Time Runners 18: The Killer Shadow TimeRunners18	T/Time Runners 18 The Kil V2	A-Games:T/TimeRunnersSeries/TimeRunners18.Slave
Time Runners 23: The Time Monarch TimeRunners23	T/Time Runners 23 The Tim V2	A-Games:T/TimeRunnersSeries/TimeRunners23.Slave
Time Runners 16: The Galaxy Emperor TimeRunners16	T/Time Runners 16 The Gal V2	A-Games:T/TimeRunnersSeries/TimeRunners16.Slave
Time Runners 17: The Living Labyrinth TimeRunners17	T/Time Runners 17 The Liv V2	A-Games:T/TimeRunnersSeries/TimeRunners17.Slave
Time Runners 12: A Target for the Cyborg TimeRunners12	T/Time Runners 12 A Targe V2	A-Games:T/TimeRunnersSeries/TimeRunners12.Slave
Time Runners 15: At the Speed of Light TimeRunners15	T/Time Runners 15 At the  V2	A-Games:T/TimeRunnersSeries/TimeRunners15.Slave
Time Runners 14: Toraxid - War Star TimeRunners14	T/Time Runners 14 Toraxid - 	A-Games:T/TimeRunnersSeries/TimeRunners14.Slave
Time Runners 09: The Time Demon TimeRunners09	T/Time Runners 09 The Tim V2	A-Games:T/TimeRunnersSeries/TimeRunners09.Slave
Time Runners 05: The Black Knight TimeRunners05	T/Time Runners 05 The Black 	A-Games:T/TimeRunnersSeries/TimeRunners05.Slave
Time Runners 11: The Steel City TimeRunners11	T/Time Runners 11 The Steel 	A-Games:T/TimeRunnersSeries/TimeRunners11.Slave
Time Runners 10: The Time Sentry TimeRunners10	T/Time Runners 10 The Tim V2	A-Games:T/TimeRunnersSeries/TimeRunners10.Slave
Time Runners 13: Cyberkiller TimeRunners13	T/Time Runners 13 Cyberki V2	A-Games:T/TimeRunnersSeries/TimeRunners13.Slave
Time Runners 04: The Castle of Fear TimeRunners04	T/Time Runners 04 The Cas V2	A-Games:T/TimeRunnersSeries/TimeRunners04.Slave
Time Runners 07: In the Land of the Invaders TimeRunners07	T/Time Runners 07 In the  V2	A-Games:T/TimeRunnersSeries/TimeRunners07.Slave
Time Runners 06: The Bewitched Forest TimeRunners06	T/Time Runners 06 The Bew V2	A-Games:T/TimeRunnersSeries/TimeRunners06.Slave
Time Runners 01: Gateways in Time TimeRunners01	T/Time Runners 01 Gateway V2	A-Games:T/TimeRunnersSeries/TimeRunners01.Slave
Time Runners 08: The Impregnable Fortress TimeRunners08	T/Time Runners 08 The Imp V2	A-Games:T/TimeRunnersSeries/TimeRunners08.Slave
Time Runners 03: The Big Run TimeRunners03	T/Time Runners 03 The Big V2	A-Games:T/TimeRunnersSeries/TimeRunners03.Slave
Time Runners 02: The Space Stone TimeRunners02	T/Time Runners 02 The Space 	A-Games:T/TimeRunnersSeries/TimeRunners02.Slave
Time Scanner	T/Time Scanner	A-Games:T/TimeScanner/TimeScanner.Slave
Times of Lore	T/Times of Lore	A-Games:T/TimesOfLore/TimesOfLore.Slave
Time Soldier	T/Time Soldier	A-Games:T/TimeSoldier/TimeSoldier.Slave
Tintin on the Moon Files	T/Tintin on the Moon Files	A-Games:T/TintinOnTheMoonFiles/TintinOnTheMoonFiles.Slave
Tintin on the Moon Image	T/Tintin on the Moon Image	A-Games:T/TintinOnTheMoonImage/TintinOnTheMoonImage.Slave
Tiny Skweeks	T/Tiny Skweeks	A-Games:T/TinySkweeks/TinySkweeks.Slave
Tiny Troops	T/Tiny Troops	A-Games:T/TinyTroops/TinyTroops.Slave
Tiny Troops CD	T/Tiny Troops CD	A-Games:T/TinyTroopsCD/TinyTroopsCD.Slave
Tiny Troops DE CD	T/Tiny Troops DE CD	A-Games:T/TinyTroopsCDDe/TinyTroopsCDDe.Slave
Tip Off	T/Tip Off	A-Games:T/TipOff/TipOff.Slave
Tip Off IT FR ES DE	T/Tip Off IT FR ES DE	A-Games:T/TipOffDeEsFrIt/TipOffDeEsFrIt.Slave
Tip Off NTSC	T/Tip Off NTSC	A-Games:T/TipOffNTSC/TipOffNTSC.Slave
Titan	T/Titan	A-Games:T/Titan/Titan.slave
Titanic Blinky	T/Titanic Blinky	A-Games:T/TitanicBlinky/TitanicBlinky.Slave
Titus the Fox	T/Titus the Fox	A-Games:T/TitusTheFox/TitusTheFox.slave
Toki	T/Toki	A-Games:T/Toki/Toki.slave
Tom and the Ghost	T/Tom and the Ghost	A-Games:T/TomAndTheGhost/TomAndTheGhost.Slave
Tom Landry Strategy Football	T/Tom Landry Strategy Footba	A-Games:T/TomLandryFootball/TomLandryFootball.Slave
Tom Landry Strategy Football	T/Tom Landry Strategy Foo V2	A-Games:T/TomLandryFootballDeluxe/TomLandryFootballDeluxe.Slave
Tommy Gun	T/Tommy Gun	A-Games:T/TommyGun/TommyGun.Slave
Tony & Friends in Kellogg's Land	T/Tony Friends in Kelloggs L	A-Games:T/Tony&Friends/Tony&Friends.Slave
Tony & Friends in Kellogg's Land DE	T/Tony Friends in Kellogg V2	A-Games:T/Tony&FriendsDe/Tony&FriendsDe.Slave
Toobin'	T/Toobin	A-Games:T/Toobin/Toobin.Slave
Top Banana	T/Top Banana	A-Games:T/TopBanana/TopBanana.Slave
Top Cat	T/Top Cat	A-Games:T/TopCat/TopCat.Slave
TopGear 2	T/TopGear 2	A-Games:T/TopGear2/TopGear2.Slave
Top Secret	T/Top Secret	A-Games:T/TopSecret/TopSecret.Slave
Tornado	T/Tornado	A-Games:T/Tornado/Tornado.slave
Tornado Ground Attack	T/Tornado Ground Attack	A-Games:T/TornadoGroundAttack/TornadoGroundAttack.Slave
Torvak the Warrior	T/Torvak the Warrior	A-Games:T/TorvakTheWarrior/TorvakTheWarrior.slave
Total Eclipse	T/Total Eclipse	A-Games:T/TotalEclipse/TotalEclipse.Slave
Total Eclipse NTSC	T/Total Eclipse NTSC	A-Games:T/TotalEclipseNTSC/TotalEclipseNTSC.Slave
Total Football	T/Total Football	A-Games:T/TotalFootball/TotalFootball.Slave
Total Recall Files	T/Total Recall Files	A-Games:T/TotalRecallFiles/TotalRecallFiles.Slave
Total Recall Image	T/Total Recall Image	A-Games:T/TotalRecallImage/TotalRecallImage.Slave
Tournament Golf	T/Tournament Golf	A-Games:T/TournamentGolf/TournamentGolf.Slave
Tower of Babel	T/Tower of Babel	A-Games:T/TowerOfBabel/TowerOfBabel.Slave
Tower Toppler NTSC	T/Tower Toppler NTSC	A-Games:T/TowerTopplerNTSC/TowerTopplerNTSC.slave
Town with No Name, The CDTV	T/Town with No Name. The CDT	A-Games:T/TownWithNoNameCDTV/TownWithNoNameCDTV.Slave
Toyottes, The Files	T/Toyottes. The Files	A-Games:T/ToyottesFiles/ToyottesFiles.Slave
Toyottes, The Image	T/Toyottes. The Image	A-Games:T/ToyottesImage/ToyottesImage.Slave
T-Racer	T/T-Racer	A-Games:T/TRacer/TRacer.Slave
Tracker	T/Tracker	A-Games:T/Tracker/Tracker.Slave
Traders	T/Traders	A-Games:T/Traders/Traders.slave
Traders DE	T/Traders DE	A-Games:T/TradersDe/TradersDe.slave
Trained Assassin	T/Trained Assassin	A-Games:T/TrainedAssassin/TrainedAssassin.Slave
Transarctica	T/Transarctica	A-Games:T/Transarctica/Transarctica.Slave
Transplant	T/Transplant	A-Games:T/Transplant/Transplant.Slave
TransWorld DE	T/TransWorld DE	A-Games:T/TransworldDe/TransworldDe.Slave
Traps 'n' Treasures	T/Traps n Treasures	A-Games:T/TrapsNTreasures/TrapsNTreasures.Slave
Traps 'n' Treasures DE	T/Traps n Treasures DE	A-Games:T/TrapsNTreasuresDe/TrapsNTreasuresDe.Slave
Treasure Island Dizzy	T/Treasure Island Dizzy	A-Games:T/TreasureIslandDizzy/TreasureIslandDizzy.slave
Treasures of the Savage Frontier NTSC	T/Treasures of the Savage Fr	A-Games:T/TreasureSavageFrontNTSC/TreasureSavageFrontNTSC.Slave
Treasure Trap	T/Treasure Trap	A-Games:T/TreasureTrap/TreasureTrap.slave
Trex Warrior	T/Trex Warrior	A-Games:T/TrexWarrior/TrexWarrior.slave
TrianGo	T/TrianGo	A-Games:T/TrianGO/TrianGO.Slave
Tricky-Quiky-Games: Die Suche nach den Verschollenen Seiten DE	T/Tricky-Quiky-Games Die Suc	A-Games:T/TrickyQuikyGamesDe/TrickyQuikyGamesDe.Slave
Tripple-X	T/Tripple-X	A-Games:T/TripleX/TripleX.Slave
Trivial Pursuit: Amiga Genus Edition	T/Trivial Pursuit Amiga Genu	A-Games:T/TrivialPursuit/TrivialPursuit.slave
Trivial Pursuit: Amiga Genus Edition DE	T/Trivial Pursuit Amiga G V2	A-Games:T/TrivialPursuitDe/TrivialPursuitDe.slave
Trivial Pursuit: Amiga Genus Edition FR	T/Trivial Pursuit Amiga G V3	A-Games:T/TrivialPursuitFr/TrivialPursuitFr.slave
Trivial Pursuit: A New Beginning	T/Trivial Pursuit A New Begi	A-Games:T/TrivialPursuitNewBegin/TrivialPursuitNewBegin.slave
Trivial Pursuit: A New Beginning DE	T/Trivial Pursuit A New B V2	A-Games:T/TrivialPursuitNewBeginDe/TrivialPursuitNewBeginDe.Slave
Trivial Pursuit: A New Beginning FR	T/Trivial Pursuit A New B V3	A-Games:T/TrivialPursuitNewBeginFr/TrivialPursuitNewBeginFr.Slave
Troddlers	T/Troddlers	A-Games:T/Troddlers/Troddlers.Slave
Trog	T/Trog	A-Games:T/Trog/Trog.Slave
Trolls	T/Trolls	A-Games:T/Trolls/Trolls.Slave
Tubular Worlds 1MB	T/Tubular Worlds 1MB	A-Games:T/TubularWorlds1MB/TubularWorlds1MB.Slave
Tubular Worlds 512KB	T/Tubular Worlds 512KB	A-Games:T/TubularWorlds512KB/TubularWorlds512KB.Slave
Turbo	T/Turbo	A-Games:T/Turbo/Turbo.Slave
Turbo Cup	T/Turbo Cup	A-Games:T/TurboCup/TurboCup.Slave
Turbo Cup FR	T/Turbo Cup FR	A-Games:T/TurboCupFr/TurboCupFr.Slave
Turbo Out Run	T/Turbo Out Run	A-Games:T/TurboOutRun/TurboOutRun.Slave
TurboRaketti II FI	T/TurboRaketti II FI	A-Games:T/TurboRaketti2Fi/TurboRaketti2Fi.Slave
Turbo Trax 1MB	T/Turbo Trax 1MB	A-Games:T/TurboTraxArcane1MB/TurboTraxArcane1MB.Slave
Turbo Trax 512KB	T/Turbo Trax 512KB	A-Games:T/TurboTraxArcane512KB/TurboTraxArcane512KB.Slave
Turn n' Burn	T/Turn n Burn	A-Games:T/TurnNBurn/TurnNBurn.slave
Turrican	T/Turrican	A-Games:T/Turrican/Turrican.Slave
Turrican II	T/Turrican II	A-Games:T/Turrican2/Turrican2.Slave
Turrican II CDTV	T/Turrican II CDTV	A-Games:T/Turrican2CDTV/Turrican2CDTV.Slave
Turrican II Demo	T/Turrican II Demo	A-Games:T/Turrican2Demo/Turrican2Demo.Slave
Turrican 3	T/Turrican 3	A-Games:T/Turrican3/Turrican3.Slave
Turrican 3 Demo	T/Turrican 3 Demo	A-Games:T/Turrican3Demo/Turrican3Demo.Slave
Turrican CDTV	T/Turrican CDTV	A-Games:T/TurricanCDTV/TurricanCDTV.Slave
Turrican Demo	T/Turrican Demo	A-Games:T/TurricanDemo/TurricanDemo.Slave
Turrican NTSC	T/Turrican NTSC	A-Games:T/TurricanNTSC/TurricanNTSC.Slave
Tusker	T/Tusker	A-Games:T/Tusker/Tusker.Slave
TV Sports Baseball	T/TV Sports Baseball	A-Games:T/TVSportsBaseball/TVSportsBaseball.Slave
TV Sports Basketball	T/TV Sports Basketball	A-Games:T/TVSportsBasketball/TVSportsBasketball.Slave
TV Sports Boxing	T/TV Sports Boxing	A-Games:T/TVSportsBoxing/TVSportsBoxing.Slave
TV Sports Football	T/TV Sports Football	A-Games:T/TVSportsFootball/TVSportsFootball.slave
Twintris	T/Twintris	A-Games:T/Twintris/Twintris.Slave
Twin Turbos	T/Twin Turbos	A-Games:T/TwinTurbos/TwinTurbos.slave
Twinworld: Land of Vision	T/Twinworld Land of Vision	A-Games:T/TwinWorld/TwinWorld.Slave
Twylyte	T/Twylyte	A-Games:T/Twylyte/Twylyte.Slave
Typhoon	T/Typhoon	A-Games:T/Typhoon/Typhoon.Slave
Typhoon Thompson in Search for the Sea Child NTSC	T/Typhoon Thompson in Search	A-Games:T/TyphoonThompsonNTSC/TyphoonThompsonNTSC.Slave
The Way Of The Little Dragon	T/The Way Of The Little Drag	A-Games:W/WayOfTheLittleDragon/WayOfTheLittleDragon.Slave
The Way Of The Little Dragon	T/The Way Of The Little D V2	A-Games:W/WayOfTheLittleDragonAStar/WayOfTheLittleDragonAStar.Slave