Vector Championship Run	V/Vector Championship Run	A-Games:C/ChampionshipRun/ChampionshipRun.Slave
Voyageurs Du Temps, Les: La Menace NTSC	V/Voyageurs Du Temps. Les La	A-Games:F/FutureWarsNTSC/FutureWarsNTSC.slave
Vader	V/Vader	A-Games:V/Vader/Vader.Slave
Valhalla: Before the War	V/Valhalla Before the War	A-Games:V/ValhallaBeforeTheWar/ValhallaBeforeTheWar.slave
Valhalla and the Lord of Infinity	V/Valhalla and the Lord of I	A-Games:V/ValhallaLordOfInfinity/ValhallaLordOfInfinity.slave
Vampire's Empire	V/Vampires Empire	A-Games:V/VampiresEmpire/VampiresEmpire.Slave
Vaxine	V/Vaxine	A-Games:V/Vaxine/Vaxine.Slave
Vectorball	V/Vectorball	A-Games:V/Vectorball/Vectorball.Slave
Vegas Gambler	V/Vegas Gambler	A-Games:V/VegasGambler/VegasGambler.Slave
Venom Wing	V/Venom Wing	A-Games:V/VenomWing/VenomWing.Slave
Venus: The Flytrap	V/Venus The Flytrap	A-Games:V/VenusTheFlytrap/VenusTheFlytrap.Slave
Venus: The Flytrap NoIntro	V/Venus The Flytrap NoIntro	A-Games:V/VenusTheFlytrapNoIntro/VenusTheFlytrapNoIntro.Slave
Vermeer DE	V/Vermeer DE	A-Games:V/VermeerDe/VermeerDe.Slave
Viaje al Centro de la Tierra ES	V/Viaje al Centro de la Tier	A-Games:V/ViajeAlCentroDeLaTierraEs/ViajeAlCentroDeLaTierraEs.slave
Viaje al Centro de la Tierra .old ES	V/Viaje al Centro de la T V2	A-Games:V/ViajeAlCentroDeLaTierraEs/ViajeAlCentroDeLaTierraEs.old
Victory Road	V/Victory Road	A-Games:V/VictoryRoad/VictoryRoad.slave
Videokid	V/Videokid	A-Games:V/VideoKid/VideoKid.slave
Vigilante	V/Vigilante	A-Games:V/Vigilante/Vigilante.Slave
Vindicators	V/Vindicators	A-Games:V/Vindicators/Vindicators.Slave
Violator	V/Violator	A-Games:V/Violator/Violator.Slave
Virocop	V/Virocop	A-Games:V/Virocop/Virocop.Slave
Virocop 2Meg	V/Virocop 2Meg	A-Games:V/Virocop/Virocop2Meg.slave
Virus	V/Virus	A-Games:V/Virus/Virus.slave
Vital Light	V/Vital Light	A-Games:V/VitalLight/VitalLight.slave
Vixen	V/Vixen	A-Games:V/Vixen/Vixen.slave
Viz	V/Viz	A-Games:V/Viz/Viz.Slave
Volfied	V/Volfied	A-Games:V/Volfied/Volfied.Slave
Voodoo Nightmare	V/Voodoo Nightmare	A-Games:V/VoodooNightmare/VoodooNightmare.Slave
Voyager	V/Voyager	A-Games:V/Voyager/Voyager.slave
Voyages of Discovery	V/Voyages of Discovery	A-Games:V/VoyagesOfDiscovery/VoyagesOfDiscovery.slave
Voyageurs Du Temps, Les: La Menace FR	V/Voyageurs Du Temps. Les V2	A-Games:V/VoyageursDuTempsFr/VoyageursDuTempsFr.slave
Vroom	V/Vroom	A-Games:V/Vroom/Vroom.Slave
Vroom DataDisk	V/Vroom DataDisk	A-Games:V/Vroom&DataDisk/Vroom.Slave
Vroom DataDisk	V/Vroom DataDisk 	A-Games:V/Vroom&DataDisk/DataDisk.Slave
Vroom Multi-Player	V/Vroom Multi-Player	A-Games:V/VroomMultiPlayer/VroomMultiplayer.Slave
Vyper	V/Vyper	A-Games:V/Vyper/Vyper.Slave
Vyrus	V/Vyrus	A-Games:V/Vyrus/Vyrus.Slave