Picsou: Chasseur De Tr?sor SE	P/Picsou Chasseur De Trsor S	A-Games:J/JoakimVonAnkaSe/JoakimVonAnkaSe.Slave
P47 Thunderbolt	P/P47 Thunderbolt	A-Games:P/P47Thunderbolt/P47Thunderbolt.Slave
Pacific Islands	P/Pacific Islands	A-Games:P/PacificIslands/PacificIslands.Slave
Pac-Land	P/Pac-Land	A-Games:P/PacLand/PacLand.Slave
Pacman (Beta/Unreleased)	P/Pacman BetaUnreleased	A-GamesBeta:P/PacMan/PacMan.slave
Pac-Mania	P/Pac-Mania	A-Games:P/PacMania/Pacmania.Slave
Paladin	P/Paladin	A-Games:P/Paladin/Paladin.Slave
Paladin 2	P/Paladin 2	A-Games:P/Paladin2/Paladin2.Slave
Pandora	P/Pandora	A-Games:P/Pandora/Pandora.Slave
Pang	P/Pang	A-Games:P/Pang/Pang.slave
Pango	P/Pango	A-Games:P/Pango/Pango.Slave
Panza Kick Boxing	P/Panza Kick Boxing	A-Games:P/PanzaKickBoxing/PanzaKickBoxing.Slave
Panza Kick Boxing FR	P/Panza Kick Boxing FR	A-Games:P/PanzaKickBoxingFr/PanzaKickBoxingFr.Slave
Paperboy	P/Paperboy	A-Games:P/Paperboy/Paperboy.slave
Paperboy 2	P/Paperboy 2	A-Games:P/Paperboy2/Paperboy2.slave
Paradise Lost	P/Paradise Lost	A-Games:P/ParadiseLost/ParadiseLost.slave
Paradroid 90 1MB	P/Paradroid 90 1MB	A-Games:P/Paradroid901MB/Paradroid901MB.Slave
Paradroid 90 512KB	P/Paradroid 90 512KB	A-Games:P/Paradroid90512KB/Paradroid90512KB.Slave
Paragliding Simulation	P/Paragliding Simulation	A-Games:P/ParaglidingSimulation/ParaglidingSimulation.Slave
Paramax	P/Paramax	A-Games:P/Paramax/Paramax.Slave
Parasol Stars: The Story of Rainbow Islands II	P/Parasol Stars The Story of	A-Games:P/ParasolStars/ParasolStars.Slave
Paris Dakar 1990	P/Paris Dakar 1990	A-Games:P/ParisDakar90/ParisDakar90.Slave
Passing Shot	P/Passing Shot	A-Games:P/PassingShot/PassingShot.Slave
Patrician, The	P/Patrician. The	A-Games:P/Patrician/Patrician.slave
Patrizier, Der FR	P/Patrizier. Der FR	A-Games:P/PatricianFr/PatricianFr.slave
Patrizier, Der DE	P/Patrizier. Der DE	A-Games:P/PatrizierDe/PatrizierDe.slave
Pawn, The	P/Pawn. The	A-Games:P/Pawn/Pawn.Slave
Pegasus	P/Pegasus	A-Games:P/Pegasus/Pegasus.Slave
Penthouse Hot Numbers	P/Penthouse Hot Numbers	A-Games:P/PenthouseHotNumbers/PenthouseHotNumbers.Slave
Penthouse Hot Numbers Deluxe DE	P/Penthouse Hot Numbers Delu	A-Games:P/PenthouseHotNumsDlxDe/PenthouseHotNumsDlxDe.Slave
Perihelion	P/Perihelion	A-Games:P/Perihelion/Perihelion.Slave
Persian Gulf Inferno, The	P/Persian Gulf Inferno. The	A-Games:P/PersianGulfInferno/PersianGulfInferno.Slave
Personal Nightmare	P/Personal Nightmare	A-Games:P/PersonalNightmare/PersonalNightmare.Slave
Peter Beardsley's International Football NTSC	P/Peter Beardsleys Internati	A-Games:P/PeterBeardsleysIFNTSC/PeterBeardsleysIFNTSC.Slave
Peter Pan DE	P/Peter Pan DE	A-Games:P/PeterPanDe/PeterPanDe.Slave
Peter Pan FR	P/Peter Pan FR	A-Games:P/PeterPanFr/PeterPanFr.Slave
Peter Schmeichel Soccer	P/Peter Schmeichel Soccer	A-Games:P/PeterSchmeichelSoccer/PeterSchmeichelSoccer.Slave
PGA European Tour	P/PGA European Tour	A-Games:P/PGAEuropeanTour/PGAEuropeanTour.Slave
PGA Tour Golf	P/PGA Tour Golf	A-Games:P/PGATourGolf/PGATourGolf.Slave
PGA Tour Golf TourDisk	P/PGA Tour Golf TourDisk	A-Games:P/PGATourGolf&TourDisk/PGATourGolf&TourDisk.Slave
Phalanx	P/Phalanx	A-Games:P/Phalanx/Phalanx.Slave
Phantasie	P/Phantasie	A-Games:P/Phantasie/Phantasie.Slave
Phantasie III: The Wrath of Nikademus	P/Phantasie III The Wrath of	A-Games:P/Phantasie3/Phantasie3.Slave
Phantasm	P/Phantasm	A-Games:P/Phantasm/Phantasm.Slave
Phantom Fighter	P/Phantom Fighter	A-Games:P/PhantomFighter/PhantomFighter.Slave
Pharaoh's Curse	P/Pharaohs Curse	A-Games:P/PharaohsCurse/PharaohsCurse.Slave
Pharaohs Match	P/Pharaohs Match	A-Games:P/PharaohsMatchArcadia/PharaohsMatchArcadia.Slave
Phobia	P/Phobia	A-Games:P/Phobia/Phobia.Slave
Photon Storm	P/Photon Storm	A-Games:P/PhotonStorm/PhotonStorm.slave
Pick 'n Pile	P/Pick n Pile	A-Games:P/PickNPile/PickNPile.Slave
Picsou: Chasseur De Tr?sor FR	P/Picsou Chasseur De Trsor F	A-Games:P/PicsouChasseurDeTresorFr/PicsouchasseurDeTresorFr.Slave
Pinball Dreams	P/Pinball Dreams	A-Games:P/PinballDreams/PinballDreams.Slave
Pinball Dreams NTSC	P/Pinball Dreams NTSC	A-Games:P/PinballDreamsNTSC/PinballDreamsNTSC.Slave
Pinball Fantasies	P/Pinball Fantasies	A-Games:P/PinballFntsies/PinballFntsies.slave
Pinball Hazard	P/Pinball Hazard	A-Games:P/PinballHazard/PinballHazard.Slave
Pinball Magic	P/Pinball Magic	A-Games:P/PinballMagic/PinballMagic.Slave
Pinball Prelude	P/Pinball Prelude	A-Games:P/PinballPrelude/PinballPrelude.slave
Pinball Wizard	P/Pinball Wizard	A-Games:P/PinballWizard/PinballWizard.Slave
Pinball Wizard Prerelease	P/Pinball Wizard Prerelease	A-Games:P/PinballWizardPrerelease/PinballWizardPrerelease.Slave
Pinkie	P/Pinkie	A-Games:P/Pinkie/Pinkie.slave
Pink Panther	P/Pink Panther	A-Games:P/PinkPanther/PinkPanther.slave
Pinomania	P/Pinomania	A-Games:P/Pinomania/Pinomania.Slave
Pipe Dream NTSC	P/Pipe Dream NTSC	A-Games:P/PipeDreamNTSC/PipeDreamNTSC.Slave
Pipeline	P/Pipeline	A-Games:P/PipelineNomad/PipelineNomad.Slave
Pipeline	P/Pipeline 	A-Games:P/PipelineOracle/PipelineOracle.Slave
Pipe Mania	P/Pipe Mania	A-Games:P/PipeMania/PipeMania.Slave
Pirates!	P/Pirates	A-Games:P/Pirates/Pirates.slave
Pit-Fighter	P/Pit-Fighter	A-Games:P/PitFighter/PitFighter.slave
Pixie and Dixie	P/Pixie and Dixie	A-Games:P/Pixie&Dixie/Pixie&Dixie.Slave
Pizza Connection DE	P/Pizza Connection DE	A-Games:P/PizzaConnectionDe/PizzaConnectionDe.Slave
Plague, The	P/Plague. The	A-Games:P/Plague/Plague.Slave
Plague, The NTSC	P/Plague. The NTSC	A-Games:P/PlagueNTSC/PlagueNTSC.Slave
Plan 9 from Outer Space	P/Plan 9 from Outer Space	A-Games:P/Plan9FromOuterSpace/Plan9FromOuterSpace.Slave
Plan 9 from Outer Space NTSC	P/Plan 9 from Outer Space NT	A-Games:P/Plan9FromOuterSpaceNTSC/Plan9FromOuterSpaceNTSC.Slave
Platoon NTSC	P/Platoon NTSC	A-Games:P/PlatoonNTSC/PlatoonNTSC.Slave
Playdays Paint	P/Playdays Paint	A-Games:P/Playdays/Playdays.Slave
Player Manager	P/Player Manager	A-Games:P/PlayerManager/PlayerManager.slave
Player Manager 2	P/Player Manager 2	A-Games:P/PlayerManager2/PlayerManager2.Slave
Player Manager DE	P/Player Manager DE	A-Games:P/PlayerManagerDe/PlayerManagerDe.slave
Player Manager FR	P/Player Manager FR	A-Games:P/PlayerManagerFr/PlayerManagerFr.slave
Player Manager IT	P/Player Manager IT	A-Games:P/PlayerManagerIt/PlayerManagerIt.slave
Playhouse Strippoker	P/Playhouse Strippoker	A-Games:P/PlayhouseStripPoker/PlayhouseStripPoker.Slave
Playroom, The: La Chambre De Peppy FR	P/Playroom. The La Chambre D	A-Games:P/PlayroomFr/PlayroomFr.Slave
Plotting	P/Plotting	A-Games:P/Plotting/Plotting.slave
Plutos	P/Plutos	A-Games:P/Plutos/Plutos.Slave
Plutos NTSC	P/Plutos NTSC	A-Games:P/PlutosNTSC/PlutosNTSC.Slave
Pod	P/Pod	A-Games:P/Pod/Pod.slave
Poker Nights: Teresa Personally DE	P/Poker Nights Teresa Person	A-Games:P/PokerNightsDe/PokerNightsDe.Slave
Police Quest	P/Police Quest	A-Games:P/PoliceQuest/PoliceQuest.slave
Police Quest II	P/Police Quest II	A-Games:P/PoliceQuest2/PoliceQuest2.slave
Police Quest III: The Kindred DE	P/Police Quest III The Kindr	A-Games:P/PoliceQuest3De/PoliceQuest3De.slave
Police Quest III: The Kindred	P/Police Quest III The Ki V2	A-Games:P/PoliceQuest3DeMT32/PoliceQuest3DeMT32.slave
Police Quest III: The Kindred NTSC	P/Police Quest III The Ki V3	A-Games:P/PoliceQuest3NTSC/PoliceQuest3NTSC.slave
Police Quest III: The Kindred	P/Police Quest III The Ki V4	A-Games:P/PoliceQuest3NTSCMT32/PoliceQuest3NTSCMT32.slave
Police Quest NTSC	P/Police Quest NTSC	A-Games:P/PoliceQuestNTSC/PoliceQuestNTSC.slave
Pong	P/Pong	A-Games:P/Pong/Pong.slave
Pool	P/Pool	A-Games:P/Pool/Pool.Slave
Pool of Radiance	P/Pool of Radiance	A-Games:P/PoolOfRadiance/PoolOfRadiance.Slave
Pools of Darkness	P/Pools of Darkness	A-Games:P/PoolsOfDarkness/PoolsOfDarkness.slave
Pools of Darkness DE	P/Pools of Darkness DE	A-Games:P/PoolsOfDarknessDe/PoolsOfDarknessDe.Slave
Popeye 2	P/Popeye 2	A-Games:P/Popeye2/Popeye2.Slave
Populous	P/Populous	A-Games:P/Populous/Populous.Slave
Populous DataDisk	P/Populous DataDisk	A-Games:P/Populous&DataDisks/Populous&DataDisks.Slave
Populous II: Trials of the Olympian Gods	P/Populous II Trials of the	A-Games:P/Populous2/Populous2.slave
Populous II: Trials of the Olympian Gods ChallengeGames	P/Populous II Trials of the 	A-Games:P/Populous2&ChallengeGames/Populous2&ChallengeGames.slave
Populous NTSC	P/Populous NTSC	A-Games:P/PopulousNTSC/PopulousNTSC.Slave
Populous World Editor	P/Populous World Editor	A-Games:P/PopulousWorldEditor/PopulousWorldEditor.Slave
Portal	P/Portal	A-Games:P/Portal/Portal.slave
Portes du Temps, Les FR	P/Portes du Temps. Les FR	A-Games:P/PortesDuTempsFr/PortesDuTempsFr.Slave
Ports of Call	P/Ports of Call	A-Games:P/PortsOfCall/PortsOfCall.Slave
Ports of Call DE	P/Ports of Call DE	A-Games:P/PortsOfCallDe/PortsOfCallDe.Slave
Ports of Call FR	P/Ports of Call FR	A-Games:P/PortsOfCallFr/PortsOfCallFr.Slave
Postman Pat	P/Postman Pat	A-Games:P/PostmanPat/PostmanPat.Slave
P.O.W.	P/P.O.W.	A-Games:P/POW/POW.Slave
Power, The	P/Power. The	A-Games:P/Power/Power.Slave
Power Drift	P/Power Drift	A-Games:P/PowerDrift/PowerDrift.slave
Power Drive	P/Power Drive	A-Games:P/PowerDrive/PowerDrive.Slave
Powerdrome	P/Powerdrome	A-Games:P/Powerdrome/Powerdrome.Slave
PowerMonger	P/PowerMonger	A-Games:P/Powermonger/Powermonger.Slave
Powermonger WW1 Edition	P/Powermonger WW1 Edition	A-Games:P/PowermongerWW1Edition/PowermongerWW1Edition.slave
Power Pinball	P/Power Pinball	A-Games:P/PowerPinball/PowerPinball.slave
Power Pinball CDTV	P/Power Pinball CDTV	A-Games:P/PowerPinballCDTV/PowerPinballCDTV.slave
Powerplay: The Game of the Gods	P/Powerplay The Game of the	A-Games:P/Powerplay/Powerplay.Slave
Powerplay: The Game of the Gods DE	P/Powerplay The Game of the 	A-Games:P/PowerplayDe/PowerplayDe.Slave
Powerplay: The Game of the Gods ES	P/Powerplay The Game of t V2	A-Games:P/PowerplayEs/PowerplayEs.Slave
Powerplay: The Game of the Gods FR	P/Powerplay The Game of t V3	A-Games:P/PowerplayFr/PowerplayFr.Slave
Powerplay: The Game of the Gods GR	P/Powerplay The Game of t V4	A-Games:P/PowerplayGr/PowerplayGr.Slave
Power Styx	P/Power Styx	A-Games:P/Powerstyx/Powerstyx.slave
P.P. Hammer	P/P.P. Hammer	A-Games:P/PPHammer/PPHammer.Slave
Predator	P/Predator	A-Games:P/Predator/Predator.Slave
Predator 2	P/Predator 2	A-Games:P/Predator2/Predator2.Slave
Prehistorik	P/Prehistorik	A-Games:P/Prehistorik/Prehistorik.slave
Prehistorik CDTV	P/Prehistorik CDTV	A-Games:P/PrehistorikCDTV/PrehistorikCDTV.slave
Premiere	P/Premiere	A-Games:P/Premiere/Premiere.slave
Premier Manager	P/Premier Manager	A-Games:P/PremierManager/PremierManager.Slave
Premier Manager II	P/Premier Manager II	A-Games:P/PremierManager2/PremierManager2.Slave
Premier Manager 3	P/Premier Manager 3	A-Games:P/PremierManager3/PremierManager3.Slave
Premier Manager 3 Deluxe	P/Premier Manager 3 Deluxe	A-Games:P/PremierManager3Deluxe/PremierManager3Deluxe.Slave
Prime Mover	P/Prime Mover	A-Games:P/PrimeMover/PrimeMover.Slave
Prince	P/Prince	A-Games:P/Prince/Prince.slave
Prince of Persia FR	P/Prince of Persia FR	A-Games:P/PrinceDePerseFr/PrinceDePerseFr.slave
Prince of Persia	P/Prince of Persia	A-Games:P/PrinceOfPersia/PrinceOfPersia.slave
Prince of Persia DE	P/Prince of Persia DE	A-Games:P/PrinceOfPersiaDe/PrinceOfPersiaDe.slave
Prince of Persia NTSC	P/Prince of Persia NTSC	A-Games:P/PrinceOfPersiaNTSC/PrinceOfPersiaNTSC.slave
Prison	P/Prison	A-Games:P/Prison/Prison.Slave
Prison NTSC	P/Prison NTSC	A-Games:P/PrisonNTSC/PrisonNTSC.slave
Pro Boxing Simulator	P/Pro Boxing Simulator	A-Games:P/ProBoxingSimulator/ProBoxingSimulator.Slave
Profezia IT	P/Profezia IT	A-Games:P/ProfeziaIt/ProfeziaIt.Slave
Project-X	P/Project-X	A-Games:P/ProjectX/ProjectX.slave
Project-X	P/Project-X 	A-Games:P/ProjectXBonusLevel/ProjectXBonusLevel.Slave
Project-X Special Edition 93	P/Project-X Special Edition	A-Games:P/ProjectXSE/ProjectXSE.Slave
Project-X 2017 (Beta/Unreleased)	P/Project-X 2017 BetaUnrelea	A-GamesBeta:P/ProjectXSE2017/ProjectXSE2017.slave
Project-X	P/Project-X  	A-Games:P/ProjectXv2/ProjectXv2.slave
Projectyle	P/Projectyle	A-Games:P/Projectyle/Projectyle.slave
Prophecy I: The Viking Child	P/Prophecy I The Viking Chil	A-Games:P/Prophecy1VikingChild/Prophecy1VikingChild.Slave
Pro Powerboat Simulator	P/Pro Powerboat Simulator	A-Games:P/ProPowerBoatSimulator/ProPowerBoatSimulator.Slave
ProSoccer 2190	P/ProSoccer 2190	A-Games:P/ProSoccer2190/ProSoccer2190.Slave
Prospector in the Mazes of Xor	P/Prospector in the Mazes of	A-Games:P/ProspectorInTheMazesOfXor/ProspectorInTheMazesOfXor.Slave
Pro Tennis Simulator Files	P/Pro Tennis Simulator Files	A-Games:P/ProTennisSimulatorFiles/ProTennisSimulatorFiles.slave
Pro Tennis Simulator Image	P/Pro Tennis Simulator Image	A-Games:P/ProTennisSimulatorImage/ProTennisSimulatorImage.slave
Pro Tennis Tour	P/Pro Tennis Tour	A-Games:P/ProTennisTour/ProTennisTour.slave
Pro Tennis Tour 2	P/Pro Tennis Tour 2	A-Games:P/ProTennisTour2/ProTennisTour2.slave
Pro Tennis Tour 2 512KB	P/Pro Tennis Tour 2 512KB	A-Games:P/ProTennisTour2512KB/ProTennisTour2512KB.slave
Psyborg	P/Psyborg	A-Games:P/Psyborg/Psyborg.Slave
Psycho Killer CDTV	P/Psycho Killer CDTV	A-Games:P/PsychoKillerCDTV/PsychoKillerCDTV.Slave
Psycho Santa	P/Psycho Santa	A-Games:P/PsychoSanta/PsychoSanta.Slave
Pub Trivia Simulator	P/Pub Trivia Simulator	A-Games:P/PubTriviaSimulator/PubTriviaSimulator.Slave
Puffy's Saga	P/Puffys Saga	A-Games:P/PuffysSaga/PuffysSaga.Slave
Puggsy	P/Puggsy	A-Games:P/Puggsy/Puggsy.slave
Purple Saturn Day	P/Purple Saturn Day	A-Games:P/PurpleSaturnDay/PurpleSaturnDay.slave
Purple Saturn Day NTSC	P/Purple Saturn Day NTSC	A-Games:P/PurpleSaturnDayNTSC/PurpleSaturnDayNTSC.Slave
Pushover	P/Pushover	A-Games:P/PushOver/PushOver.slave
Putty	P/Putty	A-Games:P/Putty/Putty.Slave
Puzznic	P/Puzznic	A-Games:P/Puzznic/Puzznic.Slave
Pyramax	P/Pyramax	A-Games:P/Pyramax/Pyramax.Slave
Putty	P/Putty 	A-Games:S/SillyPutty/SillyPutty.Slave