Academy	A/Academy	A-Games:A/Academy/Academy.slave
Action Fighter	A/Action Fighter	A-Games:A/ActionFighter/ActionFighter.slave
Addams Family, The (Beta/Unreleased)	A/Addams Family. The BetaUnr	A-GamesBeta:A/AddamsFamily/AddamsFamily.slave
Adrenalynn	A/Adrenalynn	A-Games:A/Adrenalynn/Adrenalynn.Slave
Adventures of Quik & Silva, The	A/Adventures of Quik Silva.	A-Games:A/AdventuresOfQuik&Silva/AdventuresOfQuik&Silva.Slave
Adventures of Robin Hood, The	A/Adventures of Robin Hood.	A-Games:A/AdventuresOfRobinHood/AdventuresOfRobinHood.slave
Afterburner	A/Afterburner	A-Games:A/AfterBurner/AfterBurner.Slave
Afterburner NTSC	A/Afterburner NTSC	A-Games:A/AfterBurnerNTSC/AfterBurnerNTSC.slave
After the War	A/After the War	A-Games:A/AfterTheWar/AfterTheWar.Slave
Agony	A/Agony	A-Games:A/Agony/Agony.slave
Agony Demo	A/Agony Demo	A-Games:A/AgonyDemo/AgonyDemo.slave
Agony NTSC	A/Agony NTSC	A-Games:A/AgonyNTSC/AgonyNTSC.slave
Airball	A/Airball	A-Games:A/Airball/Airball.slave
Airborne Ranger	A/Airborne Ranger	A-Games:A/AirborneRanger/AirborneRanger.Slave
Albedo FR	A/Albedo FR	A-Games:A/AlbedoFr/AlbedoFr.slave
Alcatraz	A/Alcatraz	A-Games:A/Alcatraz/Alcatraz.slave
Alchemy Demo	A/Alchemy Demo	A-Games:A/AlchemyDemo/AlchemyDemo.Slave
Alianator	A/Alianator	A-Games:A/Alianator/Alianator.Slave
Alien Bash	A/Alien Bash	A-Games:A/AlienBash/AlienBash.Slave
Alien Legion	A/Alien Legion	A-Games:A/AlienLegion/AlienLegion.Slave
Alien Storm	A/Alien Storm	A-Games:A/AlienStorm/AlienStorm.Slave
Alien World	A/Alien World	A-Games:A/AlienWorld/AlienWorld.Slave
Aliex	A/Aliex	A-Games:A/Aliex/Aliex.Slave
Alpha-1	A/Alpha-1	A-Games:A/Alpha1/Alpha1.Slave
Altered Beast	A/Altered Beast	A-Games:A/AlteredBeast/AlteredBeast.slave
Amegas	A/Amegas	A-Games:A/Amegas/Amegas.Slave
American Gladiators	A/American Gladiators	A-Games:A/AmericanGladiators/AmericanGladiators.slave
American Tag-Team Wrestling	A/American Tag-Team Wrestlin	A-Games:A/AmericanTagTeamWrestling/AmericanTagTeamWrestling.Slave
Anarchy	A/Anarchy	A-Games:A/Anarchy/Anarchy.Slave
Apache Flight	A/Apache Flight	A-Games:A/ApacheFlight/ApacheFlight.slave
APB	A/APB	A-Games:A/APB/APB.slave
Apidya	A/Apidya	A-Games:A/ApidyaAudios/ApidyaAudios.slave
Apidya	A/Apidya 	A-Games:A/ApidyaKaiko/ApidyaKaiko.slave
Apidya SE (Beta/Unreleased)	A/Apidya SE BetaUnreleased	A-GamesBeta:A/ApidyaSpecialEdition/ApidyaSE.slave
Apple Hunt	A/Apple Hunt	A-Games:A/AppleHunt/AppleHunt.slave
Apprentice	A/Apprentice	A-Games:A/Apprentice/Apprentice.slave
Aquaventura	A/Aquaventura	A-Games:A/Aquaventura/Aquaventura.Slave
Aquaventura NTSC	A/Aquaventura NTSC	A-Games:A/AquaventuraNTSC/AquaventuraNTSC.Slave
Arcade Fruit Machine	A/Arcade Fruit Machine	A-Games:A/ArcadeFruitMachine/ArcadeFruitMachine.Slave
Arcade Trivia Quiz	A/Arcade Trivia Quiz	A-Games:A/ArcadeTriviaQuiz/ArcadeTriviaQuiz.slave
Archer MacLean Presents: Billard Americain	A/Archer MacLean Presents Bi	A-Games:A/ArcherMacLeansBillardAmcn/ArcherMacLeansBillardAmcn.Slave
Archer Maclean's Pool	A/Archer Macleans Pool	A-Games:A/ArcherMacLeansPool/ArcherMacLeansPool.Slave
Archipelagos	A/Archipelagos	A-Games:A/Archipelagos/Archipelagos.Slave
Archipelagos NTSC	A/Archipelagos NTSC	A-Games:A/ArchipelagosNTSC/ArchipelagosNTSC.Slave
Arena	A/Arena	A-Games:A/Arena/Arena.slave
Arkanoid	A/Arkanoid	A-Games:A/Arkanoid/Arkanoid.Slave
Arkanoid NTSC	A/Arkanoid NTSC	A-Games:A/ArkanoidNTSC/ArkanoidNTSC.Slave
Arkanoid: Revenge of Doh	A/Arkanoid Revenge of Doh	A-Games:A/ArkanoidRevengeOfDoh/ArkanoidRevengeOfDoh.slave
Armageddon Man, The	A/Armageddon Man. The	A-Games:A/ArmageddonMan/ArmageddonMan.Slave
Armalyte (Beta/Unreleased)	A/Armalyte BetaUnreleased	A-GamesBeta:A/Armalyte/Armalyte.Slave
Armalyte	A/Armalyte	A-Games:A/Armalyte/Armalyte.Slave
Army Moves	A/Army Moves	A-Games:A/ArmyMoves/ArmyMoves.Slave
Arnie	A/Arnie	A-Games:A/Arnie/Arnie.slave
Artura	A/Artura	A-Games:A/Artura/Artura.Slave
Astaroth	A/Astaroth	A-Games:A/Astaroth/Astaroth.Slave
Astro Marine Corps	A/Astro Marine Corps	A-Games:A/AstroMarineCorps/AstroMarineCorps.Slave
ATF II - Advanced Tactical Fighter II	A/ATF II - Advanced Tactical	A-Games:A/ATF2/ATF2.Slave
Atlantyda PL	A/Atlantyda PL	A-Games:A/AtlantydaPl/AtlantydaPl.slave
Atomic Robo-Kid	A/Atomic Robo-Kid	A-Games:A/AtomicRoboKid/AtomicRoboKid.Slave
Atomino	A/Atomino	A-Games:A/Atomino/Atomino.slave
Atomino DE	A/Atomino DE	A-Games:A/AtominoDe/AtominoDe.slave
Atomino NTSC	A/Atomino NTSC	A-Games:A/AtominoNTSC/AtominoNTSC.slave
Atomix	A/Atomix	A-Games:A/Atomix/Atomix.Slave
Atom Smasher	A/Atom Smasher	A-Games:A/AtomSmasher/AtomSmasher.Slave
Aunt Arctic Adventure	A/Aunt Arctic Adventure	A-Games:A/AuntArcticAdventure/AuntArcticAdventure.Slave
AWESOME	A/AWESOME	A-Games:A/Awesome/Awesome.Slave
AWESOME Demo	A/AWESOME Demo	A-Games:A/AwesomeDemo/AwesomeDemo.Slave
Axel's Magic Hammer	A/Axels Magic Hammer	A-Games:A/AxelsMagicHammer/AxelsMagicHammer.Slave
A Prehistoric Tale	A/A Prehistoric Tale	A-Games:P/PrehistoricTale/PrehistoricTale.slave
A Question of Sport	A/A Question of Sport	A-Games:Q/QuestionOfSport/QuestionOfSport.Slave