Gadget: Lost in Time	G/Gadget Lost in Time	A-Games:G/GadgetLostInTime/GadgetLostInTime.slave
Gainforce	G/Gainforce	A-Games:G/Gainforce/Gainforce.Slave
Galactic Conqueror	G/Galactic Conqueror	A-Games:G/GalacticConqueror/GalacticConqueror.Slave
Galactic Empire	G/Galactic Empire	A-Games:G/GalacticEmpire/GalacticEmpire.Slave
Galactic: The Xmas Edition 1MB	G/Galactic The Xmas Edition	A-Games:G/GalacticTheXmasEdition1MB/GalacticTheXmasEdition1MB.Slave
Galactic: The Xmas Edition 2MB	G/Galactic The Xmas Edition 	A-Games:G/GalacticTheXmasEdition2MB/GalacticTheXmasEdition2MB.Slave
Galactic Warrior Rats	G/Galactic Warrior Rats	A-Games:G/GalacticWarriorRats/GalacticWarriorRats.slave
Galaga '92	G/Galaga 92	A-Games:G/Galaga92/Galaga92.Slave
Galaxy '89	G/Galaxy 89	A-Games:G/Galaxy89/Galaxy89.slave
Galaxy Blast	G/Galaxy Blast	A-Games:G/GalaxyBlast/GalaxyBlast.Slave
Galaxy Force II	G/Galaxy Force II	A-Games:G/GalaxyForce2/GalaxyForce2.slave
Galdregon's Domain	G/Galdregons Domain	A-Games:G/GaldregonsDomain/GaldregonsDomain.Slave
Game of Harmony, The NTSC	G/Game of Harmony. The NTSC	A-Games:G/GameOfHarmonyNTSC/GameOfHarmonyNTSC.Slave
Ganymed	G/Ganymed	A-Games:G/Ganymed/Ganymed.slave
Garfield: Winter's Tail	G/Garfield Winters Tail	A-Games:G/GarfieldAWintersTail/GarfieldAWintersTail.Slave
Garfield: Big, Fat, Hairy Deal	G/Garfield Big. Fat. Hairy D	A-Games:G/GarfieldBigFatHairyDeal/GarfieldBigFatHairyDeal.slave
Garrison	G/Garrison	A-Games:G/Garrison/Garrison.Slave
Garrison II: The Legend Continues	G/Garrison II The Legend Con	A-Games:G/Garrison2/Garrison2.Slave
Gary Lineker's Hot Shot	G/Gary Linekers Hot Shot	A-Games:G/GaryLinekersHotShot/GaryLinekersHotShot.Slave
Gateway to the Savage Frontier	G/Gateway to the Savage Fron	A-Games:G/GatewayToSavageFrontier/GatewayToSavageFrontier.Slave
Gauntlet II	G/Gauntlet II	A-Games:G/Gauntlet2/Gauntlet2.Slave
Gauntlet III: The Final Quest	G/Gauntlet III The Final Que	A-Games:G/Gauntlet3/Gauntlet3.slave
Gazza II	G/Gazza II	A-Games:G/Gazza2/Gazza2.Slave
GBA Championship Basketball	G/GBA Championship Basketbal	A-Games:G/GBAChampionshipBB/GBAChampionshipBB.Slave
Gear Works	G/Gear Works	A-Games:G/GearWorks/GearWorks.Slave
GeeBee Air Rally	G/GeeBee Air Rally	A-Games:G/GeeBeeAirRally/GeeBeeAirRally.Slave
Geisha	G/Geisha	A-Games:G/Geisha/Geisha.Slave
Geisha DE	G/Geisha DE	A-Games:G/GeishaDe/GeishaDe.Slave
Geisha ES	G/Geisha ES	A-Games:G/GeishaEs/GeishaEs.Slave
Geisha FR	G/Geisha FR	A-Games:G/GeishaFr/GeishaFr.Slave
Gemini Wing	G/Gemini Wing	A-Games:G/GeminiWing/GeminiWing.Slave
Gem Stone Legend	G/Gem Stone Legend	A-Games:G/GemStoneLegend/GemStoneLegend.slave
Gem'X	G/GemX	A-Games:G/GemX/GemX.slave
Genesia	G/Genesia	A-Games:G/Genesia/Genesia.slave
Genesia FR	G/Genesia FR	A-Games:G/GenesiaFr/GenesiaFr.slave
Germ Crazy DE	G/Germ Crazy DE	A-Games:G/GermCrazyDe/GermCrazyDe.Slave
Gettysburg	G/Gettysburg	A-Games:G/Gettysburg/Gettysburg.Slave
Ghost Battle (Beta/Unreleased)	G/Ghost Battle BetaUnrelease	A-Beta:G/GhostBattle/GhostBattle.slave
Ghost Battle	G/Ghost Battle	A-Games:G/GhostBattle/GhostBattle.Slave
Ghostbusters II	G/Ghostbusters II	A-Games:G/Ghostbusters2/Ghostbusters2.Slave
Ghostbusters II NTSC	G/Ghostbusters II NTSC	A-Games:G/Ghostbusters2NTSC/Ghostbusters2NTSC.Slave
Ghost Chaser	G/Ghost Chaser	A-Games:G/GhostChaser/GhostChaser.Slave
Ghosts 'n Goblins	G/Ghosts n Goblins	A-Games:G/GhostsNGoblins/GhostsNGoblins.slave
Ghouls 'n Ghosts	G/Ghouls n Ghosts	A-Games:G/GhoulsNGhosts/GhoulsNGhosts.Slave
Giddy II: Hero in an Egg Shell	G/Giddy II Hero in an Egg Sh	A-Games:G/Giddy2HeroInAnEggShell/Giddy2HeroInAnEggShell.Slave
Giganoid	G/Giganoid	A-Games:G/Giganoid/Giganoid.slave
Gladiators	G/Gladiators	A-Games:G/Gladiators/Gladiators.slave
Global Gladiators	G/Global Gladiators	A-Games:G/GlobalGladiators/GlobalGladiators.slave
Global Trek	G/Global Trek	A-Games:G/GlobalTrek/GlobalTrek.Slave
Globdule	G/Globdule	A-Games:G/Globdule/Globdule.slave
Globdule NTSC	G/Globdule NTSC	A-Games:G/GlobduleNTSC/GlobduleNTSC.slave
Globulus	G/Globulus	A-Games:G/Globulus/Globulus.slave
Globulus	G/Globulus 	A-Games:G/GlobulusPR/GlobulusPR.slave
G-LOC R360	G/G-LOC R360	A-Games:G/GLOCR360/GLOCR360.slave
G.Nius	G/G.Nius	A-Games:G/GNius/GNius.Slave
Gnome	G/Gnome	A-Games:G/Gnome/Gnome.Slave
Gnome Alone	G/Gnome Alone	A-Games:G/GnomeAlone/GnomeAlone.Slave
Gnome Ranger	G/Gnome Ranger	A-Games:G/GnomeRanger/GnomeRanger.Slave
Goal!	G/Goal	A-Games:G/Goal/Goal.slave
Gobliiins	G/Gobliiins	A-Games:G/Gobliiins/Gobliiins.slave
Gobliins 2: The Prince Buffoon	G/Gobliins 2 The Prince Buff	A-Games:G/Gobliins2/Gobliins2.slave
Gobliins 2: The Prince Buffoon DE	G/Gobliins 2 The Prince B V2	A-Games:G/Gobliins2De/Gobliins2De.slave
Gobliins 2: The Prince Buffoon ES	G/Gobliins 2 The Prince B V3	A-Games:G/Gobliins2Es/Gobliins2Es.slave
Gobliins 2: The Prince Buffoon FR	G/Gobliins 2 The Prince B V4	A-Games:G/Gobliins2Fr/Gobliins2Fr.slave
Gobliins 2: The Prince Buffoon IT	G/Gobliins 2 The Prince B V5	A-Games:G/Gobliins2It/Gobliins2It.slave
Goblins 3	G/Goblins 3	A-Games:G/Goblins3/Goblins3.slave
Godfather, The	G/Godfather. The	A-Games:G/Godfather/Godfather.Slave
Gods	G/Gods	A-Games:G/Gods/Gods.slave
Gods Demo	G/Gods Demo	A-Games:G/GodsDemo/GodsDemo.Slave
Gods NTSC	G/Gods NTSC	A-Games:G/GodsNTSC/GodsNTSC.slave
Golden Axe	G/Golden Axe	A-Games:G/GoldenAxe/GoldenAxe.slave
Golden Axe NTSC	G/Golden Axe NTSC	A-Games:G/GoldenAxeNTSC/GoldenAxeNTSC.slave
Golden Eagle	G/Golden Eagle	A-Games:G/GoldenEagle/GoldenEagle.Slave
Golden Eagle 512K	G/Golden Eagle 512K	A-Games:G/GoldenEagle512k/GoldenEagle512k.Slave
Golden Path	G/Golden Path	A-Games:G/GoldenPath/GoldenPath.Slave
Gold of the Aztecs, The	G/Gold of the Aztecs. The	A-Games:G/GoldOfTheAztecs/GoldOfTheAztecs.Slave
Gold of the Aztecs, The (v1.1) Kernal1.1	G/Gold of the Aztecs. The v1	A-Games:G/GoldOfTheAztecs_Kernal1.1/GoldOfTheAztecs(v1.1).Slave
Goldrunner	G/Goldrunner	A-Games:G/Goldrunner/Goldrunner.Slave
Goldrunner II	G/Goldrunner II	A-Games:G/Goldrunner2/Goldrunner2.Slave
Goldrunner II SceneryDisk	G/Goldrunner II SceneryDisk	A-Games:G/Goldrunner2&SceneryDisks/Goldrunner2&SceneryDisks.Slave
Gold Rush!	G/Gold Rush	A-Games:G/GoldRush/GoldRush.slave
Goofy's Railway Express	G/Goofys Railway Express	A-Games:G/GoofysRailwayExpress/GoofysRailwayExpress.Slave
Gordian Tomb	G/Gordian Tomb	A-Games:G/GordianTomb/GordianTomb.slave
Gotcha	G/Gotcha	A-Games:G/GotchaPrestige/GotchaPrestige.Slave
Graeme Souness Soccer Manager	G/Graeme Souness Soccer Mana	A-Games:G/GraemeSounessSoccerManagr/GraemeSounessSoccerManagr.Slave
Graeme Souness Vector Soccer	G/Graeme Souness Vector Socc	A-Games:G/GraemeSounessVectorSoccer/GraemeSounessVectorSoccer.Slave
Graham Gooch's Second Innings	G/Graham Goochs Second Innin	A-Games:G/GrahamGoochSecondInnings/GrahamGoochSecondInnings.Slave
Graham Gooch World Class Cricket	G/Graham Gooch World Class C	A-Games:G/GrahamGoochWCCricket/GrahamGoochWCCricket.Slave
Graham Gooch World Class Cricket Test Match Special Edition	G/Graham Gooch World Clas V2	A-Games:G/GrahamGoochWCCricketSE/GrahamGoochWCCricketSE.Slave
Grand Monster Slam 1Disk	G/Grand Monster Slam 1Disk	A-Games:G/GrandMonsterSlam1Disk/GrandMonsterSlam1Disk.slave
Grand Monster Slam 2Disk	G/Grand Monster Slam 2Disk	A-Games:G/GrandMonsterSlam2Disk/GrandMonsterSlam2Disk.slave
Grand Prix 500 2 FR	G/Grand Prix 500 2 FR	A-Games:G/GrandPrix5002Fr/GrandPrix5002Fr.slave
Grand Prix Circuit	G/Grand Prix Circuit	A-Games:G/GrandPrixCircuit/GrandPrixCircuit.Slave
Grand Prix Master	G/Grand Prix Master	A-Games:G/GrandPrixMaster/GrandPrixMaster.Slave
Granny's Garden	G/Grannys Garden	A-Games:G/GrannysGarden/GrannysGarden.Slave
Gravity	G/Gravity	A-Games:G/Gravity/Gravity.Slave
Gravity-Force	G/Gravity-Force	A-Games:G/GravityForce/GravityForce.Slave
Great Courts	G/Great Courts	A-Games:G/GreatCourts/GreatCourts.slave
Great Courts 2	G/Great Courts 2	A-Games:G/GreatCourts2/GreatCourts2.slave
Great Courts 2 512KB	G/Great Courts 2 512KB	A-Games:G/GreatCourts2512KB/GreatCourts2512KB.slave
Great Giana Sisters, The	G/Great Giana Sisters. The	A-Games:G/GreatGianaSisters/GreatGianaSisters.slave
Gremlins 2: The New Batch	G/Gremlins 2 The New Batch	A-Games:G/Gremlins2/Gremlins2.Slave
Gridiron!	G/Gridiron	A-Games:G/Gridiron/Gridiron.Slave
Grid Start	G/Grid Start	A-Games:G/GridStart/GridStart.Slave
Graham Taylors Soccer Challenge	G/Graham Taylors Soccer Chal	A-Games:G/GTSoccerChallenge/GTSoccerChallenge.Slave
Guardian Angel, The	G/Guardian Angel. The	A-Games:G/GuardianAngel/GuardianAngel.Slave
Guild of Thieves, The	G/Guild of Thieves. The	A-Games:G/GuildOfThieves/GuildOfThieves.Slave
Guldkorn Expressen DK 1MB	G/Guldkorn Expressen DK 1MB	A-Games:G/GuldkornExpressenDk1MB/GuldkornExpressenDk1MB.slave
Guldkorn Expressen DK 512KB	G/Guldkorn Expressen DK 512K	A-Games:G/GuldkornExpressenDk512KB/GuldkornExpressenDk512KB.slave
Gulp!	G/Gulp	A-Games:G/Gulp/Gulp.slave
Gunboat	G/Gunboat	A-Games:G/Gunboat/Gunboat.Slave
Gunship	G/Gunship	A-Games:G/Gunship/Gunship.slave
Gunship 2000	G/Gunship 2000	A-Games:G/Gunship2000/Gunship2000.slave
Gunship NTSC	G/Gunship NTSC	A-Games:G/GunshipNTSC/GunshipNTSC.slave
Gunshoot	G/Gunshoot	A-Games:G/Gunshoot/Gunshoot.Slave
Guy Spy and the Crystals of Armageddon	G/Guy Spy and the Crystals o	A-Games:G/GuySpy/GuySpy.Slave
Guy Spy and the Crystals of Armageddon CDTV	G/Guy Spy and the Crystal V2	A-Games:G/GuySpyCDTV/GuySpyCDTV.Slave
Grid Runner	G/Grid Runner	A-Games:S/SuperGridRunner/SuperGridRunner.Slave
Greg Norman's Ultimate Golf	G/Greg Normans Ultimate Golf	A-Games:U/UltimateGolf/UltimateGolf.slave