Hard 'n' Heavy	H/Hard n Heavy	A-Games:G/Giana2/Giana2.slave
Hacker II: The Doomsday Papers	H/Hacker II The Doomsday Pap	A-Games:H/Hacker2/Hacker2.Slave
Hacker NTSC	H/Hacker NTSC	A-Games:H/HackerNTSC/HackerNTSC.Slave
Hägar	H/Hagar	A-Games:H/HagarTheHorrible/HagarTheHorrible.Slave
Hägar DE	H/Hagar DE	A-Games:H/HagarTheHorribleDe/HagarTheHorribleDe.Slave
Halley Project, The: A Mission In Our Solar System	H/Halley Project. The A Miss	A-Games:H/HalleyProject/HalleyProject.Slave
Hammer Boy	H/Hammer Boy	A-Games:H/HammerBoy/HammerBoy.slave
Hammerfist	H/Hammerfist	A-Games:H/Hammerfist/Hammerfist.Slave
Hanse DE	H/Hanse DE	A-Games:H/HanseDe/HanseDe.Slave
Harald Hårdtand: Kampen om de Rene Tænder DK	H/Harald Hardtand Kampen om	A-Games:H/HaraldHaardtandDk/HaraldHaardtandDk.slave
Hardball!	H/Hardball	A-Games:H/HardBall/HardBall.Slave
Hardball II NTSC	H/Hardball II NTSC	A-Games:H/HardBall2NTSC/HardBall2NTSC.Slave
Hard Drivin'	H/Hard Drivin	A-Games:H/HardDrivin/HardDrivin.Slave
Hard Drivin'	H/Hard Drivin 	A-Games:H/HardDrivin2/HardDrivin2.Slave
Hard 'n' Heavy	H/Hard n Heavy 	A-Games:H/HardNHeavy/HardNHeavy.slave
Harlequin 1MB	H/Harlequin 1MB	A-Games:H/Harlequin1MB/Harlequin1MB.Slave
Harlequin 512KB	H/Harlequin 512KB	A-Games:H/Harlequin512KB/Harlequin512KB.Slave
Harley-Davidson	H/Harley-Davidson	A-Games:H/HarleyDavidson/HarleyDavidson.slave
Harpoon & Battleset 1: Greenland - Iceland - United Kingdom Gap	H/Harpoon Battleset 1 Greenl	A-Games:H/Harpoon&Battleset1/Harpoon&Battleset1.Slave
Harpoon Battleset 2: North Atlantic Convoys	H/Harpoon Battleset 2 North	A-Games:H/Harpoon&Battleset2/Harpoon&Battleset2.slave
Harpoon Battleset 3: The Mediterranean Conflict	H/Harpoon Battleset 3 The Me	A-Games:H/Harpoon&Battleset3/Harpoon&Battleset3.slave
Harpoon Battleset 4: The Indian Ocean	H/Harpoon Battleset 4 The In	A-Games:H/Harpoon&Battleset4/Harpoon&Battleset4.slave
Harrier Combat Simulator NTSC	H/Harrier Combat Simulator N	A-Games:H/HarrierCombatSimNTSC/HarrierCombatSimNTSC.Slave
H.A.T.E.: Hostile All Terrain Encounter	H/H.A.T.E. Hostile All Terra	A-Games:H/HATE/HATE.slave
Hawkeye	H/Hawkeye	A-Games:H/Hawkeye/Hawkeye.slave
Head Over Heels	H/Head Over Heels	A-Games:H/HeadOverHeels/HeadOverHeels.slave
Heart of China	H/Heart of China	A-Games:H/HeartOfChina/HeartOfChina.slave
Heart of China DE	H/Heart of China DE	A-Games:H/HeartOfChinaDe/HeartOfChinaDe.slave
Heart of the Dragon 3Disk	H/Heart of the Dragon 3Disk	A-Games:H/HeartOfTheDragon3Disk/HeartOfTheDragon3Disk.Slave
Heart of the Dragon 4Disk	H/Heart of the Dragon 4Disk	A-Games:H/HeartOfTheDragon4Disk/HeartOfTheDragon4Disk.slave
Heavy Metal	H/Heavy Metal	A-Games:H/HeavyMetal/HeavyMetal.slave
Heavy Metal Heroes	H/Heavy Metal Heroes	A-Games:H/HeavyMetalHeroes/HeavyMetalHeroes.Slave
Heimdall	H/Heimdall	A-Games:H/Heimdall/Heimdall.slave
Heimdall 2: Into the Hall of Worlds	H/Heimdall 2 Into the Hall o	A-Games:H/Heimdall2/Heimdall2.Slave
Heimdall DE	H/Heimdall DE	A-Games:H/HeimdallDe/HeimdallDe.slave
Heimdall FR	H/Heimdall FR	A-Games:H/HeimdallFr/HeimdallFr.slave
Hellbent	H/Hellbent	A-Games:H/Hellbent/Hellbent.Slave
Hellfire Attack	H/Hellfire Attack	A-Games:H/HellfireAttack/HellfireAttack.Slave
Hellowoon: Das Geheimnis des Zauberstabs DE	H/Hellowoon Das Geheimnis de	A-Games:H/HellowoonDe/HellowoonDe.Slave
Hellraider	H/Hellraider	A-Games:H/Hellraider/Hellraider.slave
Hell Raisers	H/Hell Raisers	A-Games:H/HellRaisers/HellRaisers.Slave
Helter Skelter	H/Helter Skelter	A-Games:H/HelterSkelter/HelterSkelter.Slave
Heroes of the Lance	H/Heroes of the Lance	A-Games:H/HeroesOfTheLance/HeroesOfTheLance.slave
HeroQuest	H/HeroQuest	A-Games:H/HeroQuest/HeroQuest.slave
HeroQuest	H/HeroQuest 	A-Games:H/HeroQuest&ReturnWitchLord/HeroQuest&ReturnWitchLord.slave
HeroQuest II: Legacy of Sorasil	H/HeroQuest II Legacy of Sor	A-Games:H/HeroQuest2/HeroQuest2.Slave
HeroQuest DE Fix	H/HeroQuest DE Fix	A-Games:H/HeroQuestDeFix/HeroQuestDeFix.slave
Hexuma: Das Auge Des Kal DE	H/Hexuma Das Auge Des Kal DE	A-Games:H/HexumaDe/HexumaDe.Slave
High Steel	H/High Steel	A-Games:H/HighSteel/HighSteel.Slave
Highway Hawks	H/Highway Hawks	A-Games:H/HighwayHawks/HighwayHawks.Slave
Highway Patrol II	H/Highway Patrol II	A-Games:H/HighwayPatrol2/HighwayPatrol2.Slave
Hillsfar	H/Hillsfar	A-Games:H/Hillsfar/Hillsfar.Slave
Hillsfar DE	H/Hillsfar DE	A-Games:H/HillsfarDe/HillsfarDe.Slave
Hill Street Blues	H/Hill Street Blues	A-Games:H/HillStreetBlues/HillStreetBlues.Slave
Hilt: Against the Hoardes	H/Hilt Against the Hoardes	A-Games:H/Hilt/Hilt.Slave
Hilt II	H/Hilt II	A-Games:H/Hilt2/Hilt2.Slave
Hilt II DE	H/Hilt II DE	A-Games:H/Hilt2De/Hilt2De.Slave
Hired Guns 1MB	H/Hired Guns 1MB	A-Games:H/HiredGuns1MB/HiredGuns1MB.Slave
Hired Guns 512KB	H/Hired Guns 512KB	A-Games:H/HiredGuns512KB/HiredGuns512KB.Slave
Hired Guns 1MB Demo	H/Hired Guns 1MB Demo	A-Games:H/HiredGunsDemo1MB/HiredGunsDemo1MB.Slave
Hired Guns 512KB Demo	H/Hired Guns 512KB Demo	A-Games:H/HiredGunsDemo512KB/HiredGunsDemo512KB.Slave
Historyline 1914-1918	H/Historyline 1914-1918	A-Games:H/Historyline/HistoryLine.Slave
Historyline 1914-1918 DE	H/Historyline 1914-1918 DE	A-Games:H/HistorylineDe/HistoryLineDe.Slave
Historyline 1914-1918 FR	H/Historyline 1914-1918 FR	A-Games:H/HistorylineFr/HistoryLineFr.Slave
Hole-In-One	H/Hole-In-One	A-Games:H/HoleInOne/HoleInOne.slave
Hole-In-One DataDisk	H/Hole-In-One DataDisk	A-Games:H/HoleInOne&DataDisks/HoleInOne&DataDisks.Slave
Holiday Maker DE CDTV	H/Holiday Maker DE CDTV	A-Games:H/HolidayMakerCDTVDe/HolidayMakerCDTVDe.Slave
Holiday Maker DE	H/Holiday Maker DE	A-Games:H/HolidayMakerDe/HolidayMakerDe.Slave
Hollywood Poker	H/Hollywood Poker	A-Games:H/HollywoodPoker/HollywoodPoker.Slave
Hollywood Poker Pro	H/Hollywood Poker Pro	A-Games:H/HollywoodPokerPro/HollywoodPokerPro.slave
Home Alone	H/Home Alone	A-Games:H/HomeAlone/HomeAlone.Slave
Hong Kong Phooey	H/Hong Kong Phooey	A-Games:H/HongKongPhooey/HongKongPhooey.Slave
Hook	H/Hook	A-Games:H/Hook/Hook.slave
Horror Zombies from the Crypt	H/Horror Zombies from the Cr	A-Games:H/HorrorZombiesFromTheCrypt/HorrorZombiesFromTheCrypt.Slave
Hostages	H/Hostages	A-Games:H/Hostages/Hostages.Slave
Hostile Breed	H/Hostile Breed	A-Games:H/HostileBreed/HostileBreed.Slave
Hot Rod	H/Hot Rod	A-Games:H/HotRod/HotRod.Slave
Hot Rubber	H/Hot Rubber	A-Games:H/HotRubber/HotRubber.Slave
Hotshot	H/Hotshot	A-Games:H/Hotshot/Hotshot.Slave
Hound of Shadow, The	H/Hound of Shadow. The	A-Games:H/HoundOfShadow/HoundOfShadow.Slave
Huckleberry Hound in Hollywood Capers	H/Huckleberry Hound in Holly	A-Games:H/HuckleberryHound/HuckleberryHound.Slave
Hudson Hawk	H/Hudson Hawk	A-Games:H/HudsonHawk/HudsonHawk.Slave
Hugo på nye Eventyr DK	H/Hugo pa nye Eventyr DK	A-Games:H/Hugo1Dk/Hugo1Dk.Slave
Hugo på nye Eventyr FI	H/Hugo pa nye Eventyr FI	A-Games:H/Hugo1Fi/Hugo1Fi.Slave
Hugo på nye Eventyr Del 2 DK	H/Hugo pa nye Eventyr Del 2	A-Games:H/Hugo2Dk/Hugo2Dk.Slave
Hugo på nye Eventyr Del 2 FI	H/Hugo pa nye Eventyr Del 2 	A-Games:H/Hugo2Fi/Hugo2Fi.Slave
Hugo på nye Eventyr DE	H/Hugo pa nye Eventyr DE	A-Games:H/HugoDe/HugoDe.Slave
Hugo på nye Eventyr ES	H/Hugo pa nye Eventyr ES	A-Games:H/HugoEs/HugoEs.Slave
Hugo på nye Eventyr SE	H/Hugo pa nye Eventyr SE	A-Games:H/HugoSe/HugoSe.Slave
Human Killing Machine	H/Human Killing Machine	A-Games:H/HumanKillingMachine/HumanKillingMachine.slave
Humans, The	H/Humans. The	A-Games:H/Humans/Humans.slave
Humans 2: The Jurassic Levels	H/Humans 2 The Jurassic Leve	A-Games:H/Humans2/Humans2.slave
Humans 2: The Jurassic Levels DE	H/Humans 2 The Jurassic L V2	A-Games:H/Humans2De/Humans2De.slave
Humans, The DE	H/Humans. The DE	A-Games:H/HumansDe/HumansDe.slave
Humans, The FR	H/Humans. The FR	A-Games:H/HumansFr/HumansFr.slave
Hunter	H/Hunter	A-Games:H/Hunter/Hunter.Slave
Hunter DE	H/Hunter DE	A-Games:H/HunterDe/HunterDe.slave
Hunter FR	H/Hunter FR	A-Games:H/HunterFr/HunterFr.slave
Hunt for Red October, The	H/Hunt for Red October. The	A-Games:H/HuntForRedOctoberTheMovie/HuntForRedOctoberTheMovie.Slave
Hybris	H/Hybris	A-Games:H/Hybris/Hybris.slave
Hybris NTSC	H/Hybris NTSC	A-Games:H/HybrisNTSC/HybrisNTSC.Slave
Hydra	H/Hydra	A-Games:H/Hydra/Hydra.Slave
Hyperdome	H/Hyperdome	A-Games:H/Hyperdome/Hyperdome.Slave
Hyperion	H/Hyperion	A-Games:H/Hyperion/Hyperion.Slave
Holiday Lemmings 1993	H/Holiday Lemmings 1993	A-Games:L/LemmingsHoliday1993/LemmingsHoliday1993.Slave
Holiday Lemmings 1994	H/Holiday Lemmings 1994	A-Games:L/LemmingsHoliday1994/LemmingsHoliday1994.Slave
Holiday Lemmings 1994 Demo	H/Holiday Lemmings 1994 Demo	A-Games:L/LemmingsHolidayDemo/LemmingsHolidayDemo.Slave
Hero's Quest: So You Want To Be A Hero	H/Heros Quest So You Want To	A-Games:Q/QuestForGlory/QuestForGlory.slave