A-10 Tank Killer 2Disk	A/A-10 Tank Killer 2Disk	A-Games:A/A10TankKiller2Disk/A10TankKiller2Disk.Slave
A-10 Tank Killer 3Disk	A/A-10 Tank Killer 3Disk	A-Games:A/A10TankKiller3Disk/A10TankKiller3Disk.Slave
Aaargh!	A/Aaargh	A-Games:A/Aaargh!/Aaargh!.Slave
Aaargh!	A/Aaargh 	A-Games:A/Aaargh!Arcadia/Aaargh!Arcadia.Slave
Abandoned Places: A Time for Heroes	A/Abandoned Places A Time fo	A-Games:A/AbandonedPlaces/AbandonedPlaces.slave
Abandoned Places 2	A/Abandoned Places 2	A-Games:A/AbandonedPlaces2/AbandonedPlaces2.Slave
Abandoned Places: A Time for Heroes DE	A/Abandoned Places A Time V2	A-Games:A/AbandonedPlacesDe/AbandonedPlacesDe.slave
Abandoned Places: A Time for Heroes ES	A/Abandoned Places A Time V3	A-Games:A/AbandonedPlacesEs/AbandonedPlacesEs.slave
ABC Monday Night Football	A/ABC Monday Night Football	A-Games:A/ABCMondayNightFootball/ABCMondayNightFootball.slave
Abracadabra	A/Abracadabra	A-Games:A/Abracadabra/Abracadabra.Slave
Academy	A/Academy	A-Games:A/Academy/Academy.slave
Ace Ball PL	A/Ace Ball PL	A-Games:A/AceBallPl/AceBallPl.Slave
Action Fighter	A/Action Fighter	A-Games:A/ActionFighter/ActionFighter.slave
Addams Family, The	A/Addams Family. The	A-Games:A/AddamsFamily/AddamsFamily.slave
Addams Family, The	A/Addams Family. The 	A-Games:A/AddamsFamily/AddamsFamily.Slave
Adrenalynn	A/Adrenalynn	A-Games:A/Adrenalynn/Adrenalynn.Slave
Advanced Destroyer Simulator	A/Advanced Destroyer Simulat	A-Games:A/AdvancedDestroyerSim/AdvancedDestroyerSim.Slave
Advanced Ski Simulator	A/Advanced Ski Simulator	A-Games:A/AdvancedSkiSimulator/AdvancedSkiSimulator.slave
Advantage Tennis	A/Advantage Tennis	A-Games:A/AdvantageTennis/AdvantageTennis.slave
Adventure Construction Set	A/Adventure Construction Set	A-Games:A/AdventureConstructionSet/AdventureConstructionSet.slave
Adventures of Quik & Silva, The	A/Adventures of Quik Silva.	A-Games:A/AdventuresOfQuik&Silva/AdventuresOfQuik&Silva.Slave
Adventures of Robin Hood, The	A/Adventures of Robin Hood.	A-Games:A/AdventuresOfRobinHood/AdventuresOfRobinHood.slave
Adventures of Willy Beamish, The	A/Adventures of Willy Beamis	A-Games:A/AdventuresOfWillyBeamish/AdventuresOfWillyBeamish.slave
African Raiders-01	A/African Raiders-01	A-Games:A/AfricanRaiders01/AfricanRaiders01.slave
Afterburner	A/Afterburner	A-Games:A/AfterBurnerActivision/AfterBurnerActivision.Slave
After Burner	A/After Burner	A-Games:A/AfterBurnerSega/AfterBurnerSega.slave
After the War	A/After the War	A-Games:A/AfterTheWar/AfterTheWar.Slave
Advanced Galactic Empire	A/Advanced Galactic Empire	A-Games:A/AGE/AGE.Slave
Agony	A/Agony	A-Games:A/Agony/Agony.Slave
Agony Demo	A/Agony Demo	A-Games:A/AgonyDemo/AgonyDemo.slave
Agony NTSC	A/Agony NTSC	A-Games:A/AgonyNTSC/AgonyNTSC.Slave
Airball	A/Airball	A-Games:A/Airball/Airball.slave
Airborne Ranger	A/Airborne Ranger	A-Games:A/AirborneRanger/AirborneRanger.Slave
Air Support	A/Air Support	A-Games:A/AirSupport/AirSupport.Slave
Akira	A/Akira	A-Games:A/Akira/Akira.slave
Alcatraz	A/Alcatraz	A-Games:A/Alcatraz/Alcatraz.slave
Alchemy Demo	A/Alchemy Demo	A-Games:A/AlchemyDemo/AlchemyDemo.Slave
Alfred Chicken	A/Alfred Chicken	A-Games:A/AlfredChicken/AlfredChicken.Slave
Alianator	A/Alianator	A-Games:A/Alianator/Alianator.Slave
Alien³	A/Alien3	A-Games:A/Alien3/Alien3.Slave
Alien Bash	A/Alien Bash	A-Games:A/AlienBash/AlienBash.Slave
Alien Bash 2	A/Alien Bash 2	A-Games:A/AlienBash2/AlienBash2.slave
Alien Breed	A/Alien Breed	A-Games:A/AlienBreed/AlienBreed.Slave
Alien Breed II: The Horror Continues	A/Alien Breed II The Horror	A-Games:A/AlienBreed2/AlienBreed2.slave
Alien Breed: Special Edition 1992	A/Alien Breed Special Editio	A-Games:A/AlienBreedSpecialEdition/AlienBreedSpecialEdition.Slave
Alien Breed	A/Alien Breed 	A-Games:A/AlienBreedStory/AlienBreedStory.Slave
Alien Breed: Tower Assault	A/Alien Breed Tower Assault	A-Games:A/AlienBreedTA/AlienBreedTA.Slave
Alien Breed: Tower Assault	A/Alien Breed Tower Assault 	A-Games:A/AlienBreedTA11/AlienBreedTA11.slave
Alien Drug Lords: The Chyropian Connection	A/Alien Drug Lords The Chyro	A-Games:A/AlienDrugLords/AlienDrugLords.Slave
Alien Fish Finger	A/Alien Fish Finger	A-Games:A/AlienFishFinger/AlienFishFinger.Slave
Alien Legion	A/Alien Legion	A-Games:A/AlienLegion/AlienLegion.Slave
Alien Storm	A/Alien Storm	A-Games:A/AlienStorm/AlienStorm.Slave
Alien Syndrome	A/Alien Syndrome	A-Games:A/AlienSyndrome/AlienSyndrome.slave
Alien World	A/Alien World	A-Games:A/AlienWorld/AlienWorld.Slave
Aliex	A/Aliex	A-Games:A/Aliex/Aliex.Slave
Allan Border's Cricket	A/Allan Borders Cricket	A-Games:A/AllanBordersCricket/AllanBordersCricket.Slave
Allo Allo! Cartoon Fun!	A/Allo Allo Cartoon Fun	A-Games:A/AlloAllo/AlloAllo.Slave
ATR: All Terrain Racing	A/ATR All Terrain Racing	A-Games:A/AllTerrainRacing/AllTerrainRacing.Slave
ATR: All Terrain Racing Demo	A/ATR All Terrain Racing Dem	A-Games:A/AllTerrainRacingXmasDemo/AllTerrainRacingXmasDemo.slave
Alpha-1	A/Alpha-1	A-Games:A/Alpha1/Alpha1.Slave
Alpha Waves	A/Alpha Waves	A-Games:A/AlphaWaves/AlphaWaves.Slave
Altered Beast	A/Altered Beast	A-Games:A/AlteredBeast/AlteredBeast.slave
Altered Destiny	A/Altered Destiny	A-Games:A/AlteredDestiny/AlteredDestiny.slave
Amazing Spider-Man, The	A/Amazing Spider-Man. The	A-Games:A/AmazingSpiderMan/AmazingSpiderMan.slave
Ambermoon	A/Ambermoon	A-Games:A/Ambermoon/Ambermoon.Slave
Ambermoon DE	A/Ambermoon DE	A-Games:A/AmbermoonDe/AmbermoonDe.Slave
Amberstar	A/Amberstar	A-Games:A/Amberstar/Amberstar.slave
Amberstar DE	A/Amberstar DE	A-Games:A/AmberstarDe/AmberstarDe.slave
Amberstar DE FAST	A/Amberstar DE FAST	A-Games:A/AmberstarDeFast/AmberstarDeFast.slave
Amberstar FAST	A/Amberstar FAST	A-Games:A/AmberstarFast/AmberstarFast.slave
Amegas	A/Amegas	A-Games:A/Amegas/Amegas.Slave
American Gladiators	A/American Gladiators	A-Games:A/AmericanGladiators/AmericanGladiators.slave
American Tag-Team Wrestling	A/American Tag-Team Wrestlin	A-Games:A/AmericanTagTeamWrestling/AmericanTagTeamWrestling.Slave
Amiga Karate	A/Amiga Karate	A-Games:A/AmigaKarate/AmigaKarate.Slave
Amnios	A/Amnios	A-Games:A/Amnios/Amnios.slave
Anarchy	A/Anarchy	A-Games:A/Anarchy/Anarchy.Slave
Another World	A/Another World	A-Games:A/AnotherWorld/AnotherWorld.slave
Another World FR	A/Another World FR	A-Games:A/AnotherWorldFr/AnotherWorldFr.slave
Another World IT	A/Another World IT	A-Games:A/AnotherWorldIt/AnotherWorldIt.slave
Another World	A/Another World 	A-Games:A/AnotherWorldLostLevel/AnotherWorldLostLevel.Slave
Anstoss DE	A/Anstoss DE	A-Games:A/AnstossDe/AnstossDe.slave
Antago	A/Antago	A-Games:A/Antago/Antago.Slave
Antares: Der Griff nach den Sternen DE	A/Antares Der Griff nach den	A-Games:A/AntaresDe/AntaresDe.Slave
Apache Demo	A/Apache Demo	A-Games:A/Apache&OverdriveDemo/Apache&OverdriveDemo.Slave
Apache Flight	A/Apache Flight	A-Games:A/ApacheFlight/ApacheFlight.slave
Apano Sin	A/Apano Sin	A-Games:A/ApanoSin/ApanoSin.Slave
Apano Sin DE	A/Apano Sin DE	A-Games:A/ApanoSinDe/ApanoSinDe.Slave
APB Files	A/APB Files	A-Games:A/APBFiles/APBFiles.slave
All Points Bulletin Image	A/All Points Bulletin Image	A-Games:A/APBImage/APBImage.slave
Apidya	A/Apidya	A-Games:A/ApidyaAudios/ApidyaAudios.slave
Apidya	A/Apidya 	A-Games:A/ApidyaKaiko/ApidyaKaiko.slave
Apocalypse	A/Apocalypse	A-Games:A/Apocalypse/Apocalypse.Slave
Apprentice	A/Apprentice	A-Games:A/Apprentice/Apprentice.slave
Aquablast	A/Aquablast	A-Games:A/Aquablast/Aquablast.slave
Aquanaut	A/Aquanaut	A-Games:A/AquanautF1Licenceware/AquanautF1Licenceware.slave
Aquatic Games, The: Starring James Pond and the Aquabats	A/Aquatic Games. The Starrin	A-Games:A/AquaticGames/AquaticGames.Slave
Aquaventura	A/Aquaventura	A-Games:A/Aquaventura/Aquaventura.Slave
Aquaventura NTSC	A/Aquaventura NTSC	A-Games:A/AquaventuraNTSC/AquaventuraNTSC.Slave
Arabian Nights	A/Arabian Nights	A-Games:A/ArabianNights/ArabianNights.Slave
Arachnophobia	A/Arachnophobia	A-Games:A/Arachnophobia/Arachnophobia.Slave
Arcade Fruit Machine	A/Arcade Fruit Machine	A-Games:A/ArcadeFruitMachine/ArcadeFruitMachine.Slave
Arcade Pool	A/Arcade Pool	A-Games:A/ArcadePool/ArcadePool.slave
Arcade Trivia Quiz	A/Arcade Trivia Quiz	A-Games:A/ArcadeTriviaQuiz/ArcadeTriviaQuiz.slave
Archer MacLean Presents: Billard Americain	A/Archer MacLean Presents Bi	A-Games:A/ArcherMacLeansBillardAmcn/ArcherMacLeansBillardAmcn.Slave
Archer Maclean's Pool	A/Archer Macleans Pool	A-Games:A/ArcherMacLeansPool/ArcherMacLeansPool.Slave
Archipelagos	A/Archipelagos	A-Games:A/Archipelagos/Archipelagos.Slave
Archipelagos NTSC	A/Archipelagos NTSC	A-Games:A/ArchipelagosNTSC/ArchipelagosNTSC.Slave
Archon: The Light and the Dark	A/Archon The Light and the D	A-Games:A/Archon/Archon.slave
Archon II: Adept	A/Archon II Adept	A-Games:A/Archon2/Archon2.slave
Arcticfox	A/Arcticfox	A-Games:A/Arcticfox/Arcticfox.Slave
Arcticfox NTSC	A/Arcticfox NTSC	A-Games:A/ArcticfoxNTSC/ArcticFoxNTSC.Slave
Arena	A/Arena	A-Games:A/Arena/Arena.slave
Arkanoid	A/Arkanoid	A-Games:A/Arkanoid/Arkanoid.Slave
Arkanoid NTSC	A/Arkanoid NTSC	A-Games:A/ArkanoidNTSC/ArkanoidNTSC.Slave
Arkanoid: Revenge of Doh	A/Arkanoid Revenge of Doh	A-Games:A/ArkanoidRevengeOfDoh/ArkanoidRevengeOfDoh.slave
Armageddon Man, The	A/Armageddon Man. The	A-Games:A/ArmageddonMan/ArmageddonMan.Slave
Armalyte	A/Armalyte	A-Games:A/Armalyte/Armalyte.Slave
Armalyte	A/Armalyte 	A-Games:A/Armalyte/Armalyte.Slave
Armour-Geddon	A/Armour-Geddon	A-Games:A/ArmourGeddon/ArmourGeddon.Slave
Armour-Geddon II: Codename Hellfire	A/Armour-Geddon II Codename	A-Games:A/ArmourGeddon2/ArmourGeddon2.Slave
Armour-Geddon NTSC	A/Armour-Geddon NTSC	A-Games:A/ArmourGeddonNTSC/ArmourGeddonNTSC.Slave
Army Moves	A/Army Moves	A-Games:A/ArmyMoves/ArmyMoves.Slave
Arnie	A/Arnie	A-Games:A/Arnie/Arnie.slave
Arnie 2	A/Arnie 2	A-Games:A/Arnie2/Arnie2.Slave
Art of Chess, The	A/Art of Chess. The	A-Games:A/ArtOfChess/ArtOfChess.Slave
Artura	A/Artura	A-Games:A/Artura/Artura.Slave
Ashes of Empire	A/Ashes of Empire	A-Games:A/AshesOfEmpire/AshesOfEmpire.Slave
Ashes of Empire DE	A/Ashes of Empire DE	A-Games:A/AshesOfEmpireDe/AshesOfEmpireDe.Slave
Assassin	A/Assassin	A-Games:A/Assassin/Assassin.Slave
Assassin: Special Edition	A/Assassin Special Edition	A-Games:A/AssassinSpecialEdition/AssassinSpecialEdition.slave
Astaroth	A/Astaroth	A-Games:A/Astaroth/Astaroth.Slave
Astatin	A/Astatin	A-Games:A/Astatin/Astatin.Slave
Astérix: Operation Getafix	A/Asterix Operation Getafix	A-Games:A/AsterixOpGetafix/AsterixOpGetafix.slave
Astérix: Operation Getafix DE	A/Asterix Operation Getafix 	A-Games:A/AsterixOpHinkelsteinDe/AsterixOpHinkelsteinDe.slave
Astro Marine Corps	A/Astro Marine Corps	A-Games:A/AstroMarineCorps/AstroMarineCorps.Slave
Atax	A/Atax	A-Games:A/Atax/Atax.Slave
ATF II - Advanced Tactical Fighter II	A/ATF II - Advanced Tactical	A-Games:A/ATF2/ATF2.Slave
Atlantyda PL	A/Atlantyda PL	A-Games:A/AtlantydaPl/AtlantydaPl.slave
Atomic Robo-Kid	A/Atomic Robo-Kid	A-Games:A/AtomicRoboKid/AtomicRobokid.slave
Atomino	A/Atomino	A-Games:A/Atomino/Atomino.slave
Atomino DE	A/Atomino DE	A-Games:A/AtominoDe/AtominoDe.slave
Atomix	A/Atomix	A-Games:A/Atomix/atomix.slave
Atom Smasher	A/Atom Smasher	A-Games:A/AtomSmasher/AtomSmasher.Slave
A-Train	A/A-Train	A-Games:A/ATrain/ATrain.slave
A-Train 512K ConstrSet 512K	A/A-Train 512K ConstrSet 512	A-Games:A/ATrain&ConstrSet512k/ATrain512K.slave
A-Train ConstructionSet	A/A-Train ConstructionSet	A-Games:A/ATrain&ConstructionSet/ATrain.slave
A-Train 512K	A/A-Train 512K	A-Games:A/ATrain512k/ATrain512K.slave
A-Train CZ 512K	A/A-Train CZ 512K	A-Games:A/ATrain512kCz/ATrain512KCz.slave
A-Train DE 512K	A/A-Train DE 512K	A-Games:A/ATrain512kDe/ATrain512KDe.slave
A-Train FR 512K	A/A-Train FR 512K	A-Games:A/ATrain512kFr/ATrain512KFr.slave
A-Train PL 512K	A/A-Train PL 512K	A-Games:A/ATrain512kPl/ATrain512kPl.slave
A-Train CZ	A/A-Train CZ	A-Games:A/ATrainCz/ATrainCz.slave
A-Train DE	A/A-Train DE	A-Games:A/ATrainDe/ATrainDe.slave
A-Train FR	A/A-Train FR	A-Games:A/ATrainFr/ATrainFr.slave
A-Train PL	A/A-Train PL	A-Games:A/ATrainPl/ATrainPl.Slave
Aufschwung Ost DE	A/Aufschwung Ost DE	A-Games:A/AufschwungOstDe/AufschwungOstDe.slave
Aunt Arctic Adventure	A/Aunt Arctic Adventure	A-Games:A/AuntArcticAdventure/AuntArcticAdventure.Slave
Australo Piticus Mechanicus	A/Australo Piticus Mechanicu	A-Games:A/AustraloPiticusMechanicus/AustraloPiticusMechanicus.Slave
Auto Duel	A/Auto Duel	A-Games:A/AutoDuel/AutoDuel.Slave
AV-8B Harrier Assault	A/AV-8B Harrier Assault	A-Games:A/AV8BHarrierAssault/AV8BHarrierAssault.Slave
Aventures de Moktar, Les FR	A/Aventures de Moktar. Les F	A-Games:A/AventuresDeMoktarFr/AventuresDeMoktarFr.slave
AWESOME	A/AWESOME	A-Games:A/Awesome/Awesome.Slave
AWESOME Demo	A/AWESOME Demo	A-Games:A/AwesomeDemo/AwesomeDemo.Slave
Axel's Magic Hammer	A/Axels Magic Hammer	A-Games:A/AxelsMagicHammer/AxelsMagicHammer.Slave
Axe of Rage	A/Axe of Rage	A-Games:A/AxeOfRage/AxeOfRage.slave
Aztec Challenge	A/Aztec Challenge	A-Games:A/AztecChallenge/AztecChallenge.Slave
Antheads: It Came from the Desert II Data Disk	A/Antheads It Came from the	A-Games:I/ItCameFromTheDesert2/ItCameFromTheDesert2.Slave
A Prehistoric Tale	A/A Prehistoric Tale	A-Games:P/PrehistoricTale/PrehistoricTale.slave
A Question of Sport	A/A Question of Sport	A-Games:Q/QuestionOfSport/QuestionOfSport.Slave