Oath, The	O/Oath. The	A-Games:O/Oath/Oath.Slave
Obitus	O/Obitus	A-Games:O/Obitus/Obitus.Slave
Obliterator	O/Obliterator	A-Games:O/Obliterator/Obliterator.slave
Oblivion	O/Oblivion	A-Games:O/Oblivion/Oblivion.Slave
Obsession	O/Obsession	A-Games:O/Obsession/Obsession.Slave
Odyssey	O/Odyssey	A-Games:O/Odyssey/Odyssey.slave
Off Shore Warrior	O/Off Shore Warrior	A-Games:O/OffShoreWarrior/OffShoreWarrior.Slave
Ogre NTSC	O/Ogre NTSC	A-Games:O/OgreNTSC/OgreNTSC.Slave
Oh No! More Lemmings	O/Oh No More Lemmings	A-Games:O/OhNoMoreLemmings/OhNoMoreLemmings.Slave
Oh No! More Lemmings NTSC	O/Oh No More Lemmings NTSC	A-Games:O/OhNoMoreLemmingsNTSC/OhNoMoreLemmingsNTSC.Slave
Oil Imperium	O/Oil Imperium	A-Games:O/OilImperium/OilImperium.Slave
Oil Imperium DE	O/Oil Imperium DE	A-Games:O/OilImperiumDe/OilImperiumDe.Slave
Oktagon	O/Oktagon	A-Games:O/Oktagon/Oktagon.Slave
Omega	O/Omega	A-Games:O/Omega/Omega.Slave
Omnicron Conspiracy	O/Omnicron Conspiracy	A-Games:O/OmnicronConspiracy/OmnicronConspiracy.Slave
Omnicron Conspiracy DE	O/Omnicron Conspiracy DE	A-Games:O/OmnicronConspiracyDe/OmnicronConspiracyDe.Slave
Omnicron Conspiracy FR	O/Omnicron Conspiracy FR	A-Games:O/OmnicronConspiracyFr/OmnicronConspiracyFr.Slave
One on One NTSC	O/One on One NTSC	A-Games:O/OneOnOneNTSC/OneOnOneNTSC.slave
One Step Beyond	O/One Step Beyond	A-Games:O/OneStepBeyond/OneStepBeyond.slave
One To One Match	O/One To One Match	A-Games:O/OneToOneMatch/OneToOneMatch.Slave
Onslaught	O/Onslaught	A-Games:O/Onslaught/Onslaught.slave
On The Ball: League Edition	O/On The Ball League Edition	A-Games:O/OnTheBallLE/OnTheBallLE.slave
Ooops Up	O/Ooops Up	A-Games:O/OoopsUp/OoopsUp.Slave
Ooze	O/Ooze	A-Games:O/Ooze/Ooze.Slave
Ooze DE	O/Ooze DE	A-Games:O/OozeDe/OozeDe.Slave
Operation: Cleanstreets	O/Operation Cleanstreets	A-Games:O/OperationCleanstreets/OperationCleanstreets.Slave
Operation Combat II: By Land, Sea & Air	O/Operation Combat II By Lan	A-Games:O/OperationCombat2/OperationCombat2.Slave
Operation Firestorm	O/Operation Firestorm	A-Games:O/OperationFirestorm/OperationFirestorm.slave
Operation GII Demo	O/Operation GII Demo	A-Games:O/OperationG2Demo/OperationG2Demo.Slave
Operation Harrier	O/Operation Harrier	A-Games:O/OperationHarrier/OperationHarrier.slave
Operation Jupiter FR	O/Operation Jupiter FR	A-Games:O/OperationJupiterFr/OperationJupiterFr.Slave
Operation Neptune	O/Operation Neptune	A-Games:O/OperationNeptune/OperationNeptune.Slave
Operation Stealth	O/Operation Stealth	A-Games:O/OperationStealth/OperationStealth.slave
Operation Stealth DE	O/Operation Stealth DE	A-Games:O/OperationStealthDe/OperationStealthDe.slave
Operation Stealth ES	O/Operation Stealth ES	A-Games:O/OperationStealthEs/OperationStealthEs.slave
Operation Stealth FR	O/Operation Stealth FR	A-Games:O/OperationStealthFr/OperationStealthFr.slave
Operation Stealth IT	O/Operation Stealth IT	A-Games:O/OperationStealthIt/OperationStealthIt.slave
Operation Thunderbolt	O/Operation Thunderbolt	A-Games:O/OperationThunderbolt/OperationThunderbolt.slave
Operation Wolf	O/Operation Wolf	A-Games:O/OperationWolf/OperationWolf.Slave
Orbital Destroyer	O/Orbital Destroyer	A-Games:O/OrbitalDestroyer/OrbitalDestroyer.Slave
Oriental Games	O/Oriental Games	A-Games:O/OrientalGames/OrientalGames.Slave
Ork	O/Ork	A-Games:O/Ork/Ork.Slave
Ork Attack: The Return	O/Ork Attack The Return	A-Games:O/OrkAttackTheReturn/OrkAttackTheReturn.Slave
Ork Demo	O/Ork Demo	A-Games:O/OrkDemo/OrkDemo.Slave
Ork NTSC	O/Ork NTSC	A-Games:O/OrkNTSC/OrkNTSC.Slave
Oscar	O/Oscar	A-Games:O/Oscar/Oscar.slave
OsWALD DK	O/OsWALD DK	A-Games:O/OswaldDk/OswaldDk.Slave
OsWALD NTSC	O/OsWALD NTSC	A-Games:O/OswaldNTSC/OswaldNTSC.Slave
Outlands	O/Outlands	A-Games:O/Outlands/Outlands.slave
Outlands	O/Outlands 	A-Games:O/Outlands&DizzyDice/Outlands&DizzyDice.slave
Out of this World NTSC	O/Out of this World NTSC	A-Games:O/OutOfThisWorldNTSC/OutOfThisWorldNTSC.Slave
Out Run	O/Out Run	A-Games:O/OutRun/OutRun.slave
Out Run Europa	O/Out Run Europa	A-Games:O/OutRunEuropa/OutrunEuropa.slave
Out Run NTSC	O/Out Run NTSC	A-Games:O/OutRunNTSC/OutRunNTSC.slave
Outzone	O/Outzone	A-Games:O/Outzone/Outzone.Slave
Overdrive	O/Overdrive	A-Games:O/OverdriveInfacto/OverdriveInfacto.Slave
Overdrive	O/Overdrive 	A-Games:O/OverdriveTeam17/OverdriveTeam17.Slave
Overlander	O/Overlander	A-Games:O/Overlander/Overlander.Slave
Overlord	O/Overlord	A-Games:O/OverlordDemoRowan/OverlordDemoRowan.Slave
Overlord	O/Overlord 	A-Games:O/OverlordRowan/OverlordRowan.Slave
Over the Net NTSC	O/Over the Net NTSC	A-Games:O/OverTheNetNTSC/OverTheNetNTSC.Slave
Oxxonian	O/Oxxonian	A-Games:O/Oxxonian/Oxxonian.Slave