Baal	B/Baal	A-Games:B/Baal/Baal.Slave
Baby Jo in 'Going Home'	B/Baby Jo in Going Home	A-Games:B/BabyJoInGoingHome/BabyJoInGoingHome.Slave
Backlash	B/Backlash	A-Games:B/Backlash/Backlash.Slave
Back to the Future Part II	B/Back to the Future Part II	A-Games:B/BackToTheFuturePart2/BackToTheFuturePart2.slave
Back to the Future Part III	B/Back to the Future Part V2	A-Games:B/BackToTheFuturePart3/BackToTheFuturePart3.Slave
Back to the Future Part III NTSC	B/Back to the Future Part V3	A-Games:B/BackToTheFuturePart3NTSC/BackToTheFuturePart3NTSC.Slave
Bad Company	B/Bad Company	A-Games:B/BadCompany/BadCompany.slave
BadLands	B/BadLands	A-Games:B/BadLands/Badlands.slave
Badlands Pete	B/Badlands Pete	A-Games:B/BadlandsPete/BadlandsPete.Slave
Ball Game, The	B/Ball Game. The	A-Games:B/BallGame/BallGame.Slave
Ballistix	B/Ballistix	A-Games:B/Ballistix/Ballistix.slave
Bangkok Knights	B/Bangkok Knights	A-Games:B/BangkokKnights/BangkokKnights.slave
Banzai	B/Banzai	A-Games:B/Banzai/Banzai.Slave
Barbarian II	B/Barbarian II	A-Games:B/Barbarian2Psygnosis/Barbarian2Psygnosis.Slave
B.A.T.	B/B.A.T.	A-Games:B/BAT/BAT.slave
B.A.T. DE	B/B.A.T. DE	A-Games:B/BATDe/BATDe.slave
B.A.T. FR	B/B.A.T. FR	A-Games:B/BATFr/BATFr.slave
B.A.T. IT	B/B.A.T. IT	A-Games:B/BATIt/BATIt.Slave
Batman: The Caped Crusader	B/Batman The Caped Crusader	A-Games:B/BatmanCapedCrusader/BatmanCapedCrusader.slave
Batman: The Movie 1Disk	B/Batman The Movie 1Disk	A-Games:B/BatmanTheMovie1Disk/BatmanTheMovie1Disk.Slave
Batman: The Movie 2Disk	B/Batman The Movie 2Disk	A-Games:B/BatmanTheMovie2Disk/BatmanTheMovie2Disk.Slave
Battle Bound	B/Battle Bound	A-Games:B/BattleBound/BattleBound.Slave
Battle Command	B/Battle Command	A-Games:B/BattleCommand/BattleCommand.slave
Battleships NTSC	B/Battleships NTSC	A-Games:B/BattleshipNTSC/BattleshipNTSC.slave
Battleships	B/Battleships	A-Games:B/Battleships/Battleships.slave
Battle Squadron	B/Battle Squadron	A-Games:B/BattleSquadron/BattleSquadron.slave
Battle Squadron Demo	B/Battle Squadron Demo	A-Games:B/BattleSquadronDemo/BattleSquadronDemo.Slave
Battle Squadron NTSC	B/Battle Squadron NTSC	A-Games:B/BattleSquadronNTSC/BattleSquadronNTSC.slave
Battle Valley	B/Battle Valley	A-Games:B/BattleValley/BattleValley.Slave
BC Kid	B/BC Kid	A-Games:B/BCKid/BCKid.Slave
Beach Volley	B/Beach Volley	A-Games:B/BeachVolley/BeachVolley.Slave
Beast Busters	B/Beast Busters	A-Games:B/BeastBusters/BeastBusters.slave
Beavers	B/Beavers	A-Games:B/Beavers/Beavers.Slave
Belial	B/Belial	A-Games:B/Belial/Belial.Slave
Betrayal	B/Betrayal	A-Games:B/Betrayal/Betrayal.Slave
Beverly Hills Cop	B/Beverly Hills Cop	A-Games:B/BeverlyHillsCop/BeverlyHillsCop.slave
Beyond the Ice Palace	B/Beyond the Ice Palace	A-Games:B/BeyondTheIcePalace/BeyondTheIcePalace.Slave
Big Nose the Caveman	B/Big Nose the Caveman	A-Games:B/BigNoseTheCaveman/BigNoseTheCaveman.Slave
Big Run	B/Big Run	A-Games:B/BigRun/BigRun.Slave
Bionic Commando	B/Bionic Commando	A-Games:B/BionicCommando/BionicCommando.Slave
Bionic Commando NTSC	B/Bionic Commando NTSC	A-Games:B/BionicCommandoNTSC/BionicCommandoNTSC.Slave
Biplane Duel	B/Biplane Duel	A-Games:B/BiplaneDuel/BiplaneDuel.Slave
Black Hornet	B/Black Hornet	A-Games:B/BlackHornet/BlackHornet.Slave
Black Lamp	B/Black Lamp	A-Games:B/BlackLamp/BlackLamp.slave
Blades of Steel	B/Blades of Steel	A-Games:B/BladesOfSteel/BladesOfSteel.Slave
Blade Warrior	B/Blade Warrior	A-Games:B/BladeWarrior/BladeWarrior.slave
Blasteroids	B/Blasteroids	A-Games:B/Blasteroids/Blasteroids.slave
Blazing Thunder	B/Blazing Thunder	A-Games:B/BlazingThunder/BlazingThunder.Slave
Blinky's Scary School	B/Blinkys Scary School	A-Games:B/BlinkysScarySchool/BlinkysScarySchool.Slave
Blood Money	B/Blood Money	A-Games:B/BloodMoney/BloodMoney.slave
Bloodwych	B/Bloodwych	A-Games:B/Bloodwych/Bloodwych.Slave
Bloodwych ExtendedLevels	B/Bloodwych ExtendedLevels	A-Games:B/Bloodwych&ExtendedLevels/Bloodwych.Slave
Bloodwych ExtendedLevels	B/Bloodwych ExtendedLevels 	A-Games:B/Bloodwych&ExtendedLevels/ExtendedLevels.Slave
Blue Angel 69	B/Blue Angel 69	A-Games:B/BlueAngel69/BlueAngel69.slave
Blues Brothers, The	B/Blues Brothers. The	A-Games:B/BluesBrothers/BluesBrothers.slave
BMX Simulator	B/BMX Simulator	A-Games:B/BMXSimulator/BMXSimulator.Slave
Bob's Garden	B/Bobs Garden	A-Games:B/BobsGarden/BobsGarden.Slave
Bomb Fusion	B/Bomb Fusion	A-Games:B/BombFusion/BombFusion.Slave
Bonanza Bros	B/Bonanza Bros	A-Games:B/BonanzaBros/BonanzaBros.slave
Borobodur: The Planet of Doom	B/Borobodur The Planet of Do	A-Games:B/Borobodur/Borobodur.Slave
Botics	B/Botics	A-Games:B/Botics/Botics.slave
Brainball	B/Brainball	A-Games:B/Brainball/Brainball.slave
Brain Blasters, The	B/Brain Blasters. The	A-Games:B/BrainBlasters/BrainBlasters.Slave
Brat	B/Brat	A-Games:B/Brat/Brat.slave
Brataccas NTSC	B/Brataccas NTSC	A-Games:B/BrataccasNTSC/BrataccasNTSC.Slave
Brides of Dracula	B/Brides of Dracula	A-Games:B/BridesOfDracula/BridesOfDracula.slave
Bubble Bobble	B/Bubble Bobble	A-Games:B/BubbleBobble/BubbleBobble.slave
Bubble Bobble NTSC	B/Bubble Bobble NTSC	A-Games:B/BubbleBobbleNTSC/BubbleBobbleNTSC.slave
Bubble Gun	B/Bubble Gun	A-Games:B/BubbleGun/BubbleGun.Slave
Buffalo Bill's Wild West Show	B/Buffalo Bills Wild West Sh	A-Games:B/BuffaloBillsWildWestShow/BuffaloBillsWildWestShow.Slave
Bug Bash	B/Bug Bash	A-Games:B/BugBash/BugBash.Slave
Buggy Boy	B/Buggy Boy	A-Games:B/BuggyBoy/BuggyBoy.Slave
Buggy Boy (Beta/Unreleased)	B/Buggy Boy BetaUnreleased	A-GamesBeta:B/BuggyBoy/BuggyBoy.slave
Brain Blasters, The FR	B/Brain Blasters. The FR	A-Games:T/TellerFr/TellerFr.Slave