Eagle's Rider	E/Eagles Rider	A-Games:E/EaglesRider/EaglesRider.slave
EbonStar NTSC	E/EbonStar NTSC	A-Games:E/EbonstarNTSC/EbonstarNTSC.Slave
Eco	E/Eco	A-Games:E/Eco/Eco.Slave
Eco Phantoms	E/Eco Phantoms	A-Games:E/EcoPhantoms/EcoPhantoms.Slave
Edd the Duck!	E/Edd the Duck	A-Games:E/EddTheDuck/EddTheDuck.Slave
Edd The Duck 2: Back with a Quack!	E/Edd The Duck 2 Back with a	A-Games:E/EddTheDuck2/EddTheDuck2.Slave
Eishockey Manager DE	E/Eishockey Manager DE	A-Games:E/EishockeyManagerDe/EishockeyManagerDe.Slave
Eksperyment Delfin PL	E/Eksperyment Delfin PL	A-Games:E/EksperymentDelfinPl/EksperymentDelfinPl.Slave
Electronic Pool	E/Electronic Pool	A-Games:E/ElectronicPool/ElectronicPool.slave
Elfmania	E/Elfmania	A-Games:E/Elfmania/Elfmania.Slave
Elf	E/Elf	A-Games:E/ElfMicroValue/ElfMicroValue.Slave
Elf	E/Elf 	A-Games:E/ElfOcean/ElfOcean.slave
Elf NTSC	E/Elf NTSC	A-Games:E/ElfOceanNTSC/ElfOceanNTSC.Slave
Eliminator	E/Eliminator	A-Games:E/Eliminator/Eliminator.Slave
Elite	E/Elite	A-Games:E/Elite/Elite.Slave
Elite Advanced	E/Elite Advanced	A-Games:E/EliteAdvanced/EliteAdvanced.Slave
Elvira: Mistress of the Dark	E/Elvira Mistress of the Dar	A-Games:E/Elvira/Elvira.Slave
Elvira II: The Jaws of Cerberus	E/Elvira II The Jaws of Cerb	A-Games:E/Elvira2/Elvira2.Slave
Elvira II: The Jaws of Cerberus DE	E/Elvira II The Jaws of C V2	A-Games:E/Elvira2De/Elvira2De.Slave
Elvira II: The Jaws of Cerberus ES	E/Elvira II The Jaws of C V3	A-Games:E/Elvira2Es/Elvira2Es.Slave
Elvira II: The Jaws of Cerberus FR	E/Elvira II The Jaws of C V4	A-Games:E/Elvira2Fr/Elvira2Fr.Slave
Elvira II: The Jaws of Cerberus IT	E/Elvira II The Jaws of C V5	A-Games:E/Elvira2It/Elvira2It.Slave
Elvira: The Arcade Game	E/Elvira The Arcade Game	A-Games:E/ElviraArcade/ElviraArcade.Slave
Elvira: Mistress of the Dark DE	E/Elvira Mistress of the  V2	A-Games:E/ElviraDe/ElviraDe.Slave
Elvira: Mistress of the Dark FR	E/Elvira Mistress of the  V3	A-Games:E/ElviraFr/ElviraFr.Slave
Embryo	E/Embryo	A-Games:E/Embryo/Embryo.Slave
Embryo DE	E/Embryo DE	A-Games:E/EmbryoDe/EmbryoDe.Slave
Emerald Mine	E/Emerald Mine	A-Games:E/EmeraldMine/EmeraldMine.slave
Emerald Mine II	E/Emerald Mine II	A-Games:E/EmeraldMine2/EmeraldMine2.slave
Emerald Mine 3 Professional	E/Emerald Mine 3 Professiona	A-Games:E/EmeraldMine3/EmeraldMine3.slave
Emerald Mines emeraldminecd CD	E/Emerald Mines emeraldminec	A-Games:E/EmeraldMinesCD/emeraldminecd.slave
Emlyn Hughes International Soccer	E/Emlyn Hughes International	A-Games:E/EmlynHughesIntlSoccer/EmlynHughesIntlSoccer.slave
Emmanuelle	E/Emmanuelle	A-Games:E/Emmanuelle/Emmanuelle.Slave
Emmanuelle DE	E/Emmanuelle DE	A-Games:E/EmmanuelleDe/EmmanuelleDe.Slave
Emmanuelle ES	E/Emmanuelle ES	A-Games:E/EmmanuelleEs/EmmanuelleEs.Slave
Emmanuelle FR	E/Emmanuelle FR	A-Games:E/EmmanuelleFr/EmmanuelleFr.Slave
E-Motion	E/E-Motion	A-Games:E/EMotion/EMotion.Slave
Empire Soccer 94	E/Empire Soccer 94	A-Games:E/EmpireSoccer94/EmpireSoccer94.Slave
Enchanted Land	E/Enchanted Land	A-Games:E/EnchantedLand/EnchantedLand.Slave
Encounter	E/Encounter	A-Games:E/Encounter/Encounter.slave
Enemy 2: Missing in Action	E/Enemy 2 Missing in Action	A-Games:E/Enemy2MissingInAction/Enemy2MissingInAction.Slave
Enemy 2: Missing in Action DE	E/Enemy 2 Missing in Action 	A-Games:E/Enemy2MissingInActionDe/Enemy2MissingInActionDe.Slave
Enemy: Tempest of Violence	E/Enemy Tempest of Violence	A-Games:E/EnemyTempestOfViolence/EnemyTempestOfViolence.Slave
Enemy: Tempest of Violence DE	E/Enemy Tempest of Violence 	A-Games:E/EnemyTempestOfViolenceDe/EnemyTempestOfViolenceDe.Slave
Enemy: Tempest of Violence	E/Enemy Tempest of Violen V2	A-Games:E/EnemyTOVEasyPlay/EnemyTOVEasyPlay.Slave
Enemy: Tempest of Violence DE	E/Enemy Tempest of Violen V3	A-Games:E/EnemyTOVEasyPlayDe/EnemyTOVEasyPlayDe.Slave
Enforcer, The	E/Enforcer. The	A-Games:E/Enforcer/Enforcer.Slave
England Championship Special	E/England Championship Speci	A-Games:E/EnglandChampSpecial/EnglandChampSpecial.Slave
Enlightenment: Druid II	E/Enlightenment Druid II	A-Games:E/Enlightenment/Enlightenment.Slave
Entity Intro	E/Entity Intro	A-Games:E/Entity/Intro.slave
Entity	E/Entity	A-Games:E/Entity/Entity.slave
Entity NoIntro	E/Entity NoIntro	A-Games:E/EntityNoIntro/EntityNoIntro.slave
Epic	E/Epic	A-Games:E/Epic/Epic.slave
Epic MissionDisk	E/Epic MissionDisk	A-Games:E/Epic&MissionDisk/Epic&MissionDisk.slave
Erbe, Das DE	E/Erbe. Das DE	A-Games:E/ErbeDe/ErbeDe.Slave
Erik	E/Erik	A-Games:E/Erik/Erik.Slave
Escape from Colditz	E/Escape from Colditz	A-Games:E/EscapeFromColditz/EscapeFromColditz.Slave
Escape from the Planet of the Robot Monsters	E/Escape from the Planet of	A-Games:E/EscapeFTPOTRobotMonsters/EscapeFTPOTRobotMonsters.slave
Eskadra PL	E/Eskadra PL	A-Games:E/EskadraPl/EskadraPl.Slave
Eskimo Games	E/Eskimo Games	A-Games:E/EskimoGames/EskimoGames.Slave
España: The Games '92	E/Espana The Games 92	A-Games:E/EspanaTheGames92/EspanaTheGames92.Slave
ESWAT	E/ESWAT	A-Games:E/ESWAT/ESWAT.Slave
E.T.'s Rugby League	E/E.T.s Rugby League	A-Games:E/ETsRugbyLeague/ETsRugbyLeague.Slave
European Championship 1992	E/European Championship 1992	A-Games:E/EuropeanChampionship1992/EuropeanChampionship1992.slave
European Champions	E/European Champions	A-Games:E/EuropeanChampionsOcean/EuropeanChampionsOcean.Slave
European Football Champ	E/European Football Champ	A-Games:E/EuropeanFootballChamp/EuropeanFootballChamp.Slave
Euro Soccer	E/Euro Soccer	A-Games:E/EuroSoccer/EuroSoccer.Slave
Evil Dawn	E/Evil Dawn	A-Games:E/EvilDawn/EvilDawn.Slave
Excalibur	E/Excalibur	A-Games:E/Excalibur/Excalibur.Slave
Executioner, The	E/Executioner. The	A-Games:E/Executioner/Executioner.Slave
Exile	E/Exile	A-Games:E/Exile/Exile.Slave
Exolon	E/Exolon	A-Games:E/Exolon/Exolon.Slave
Explora II FR	E/Explora II FR	A-Games:E/Explora2Fr/Explora2Fr.Slave
Explora III: Sous Le Signe Du Serpent FR	E/Explora III Sous Le Signe	A-Games:E/Explora3Fr/Explora3Fr.Slave
Explora: Time Run FR	E/Explora Time Run FR	A-Games:E/ExploraFr/ExploraFr.Slave
Extase	E/Extase	A-Games:E/Extase/Extase.Slave
Exterminator	E/Exterminator	A-Games:E/Exterminator/Exterminator.slave
Extrial	E/Extrial	A-Games:E/Extrial/Extrial.slave
Eye	E/Eye	A-Games:E/Eye/Eye.Slave
Eye of Horus, The	E/Eye of Horus. The	A-Games:E/EyeOfHorus/EyeOfHorus.Slave
Eye of the Beholder	E/Eye of the Beholder	A-Games:E/EyeOfTheBeholder/EyeOfTheBeholder.Slave
Eye of the Beholder II: The Legend of Darkmoon	E/Eye of the Beholder II The	A-Games:E/EyeOfTheBeholder2/EyeOfTheBeholder2.Slave
Eye of the Beholder II: The Legend of Darkmoon DE	E/Eye of the Beholder II  V2	A-Games:E/EyeOfTheBeholder2De/EyeOfTheBeholder2De.Slave
Eye of the Beholder DE	E/Eye of the Beholder DE	A-Games:E/EyeOfTheBeholderDe/EyeOfTheBeholderDe.Slave
Eye of the Storm Intro	E/Eye of the Storm Intro	A-Games:E/EyeOfTheStorm/Intro.Slave
Eye of the Storm	E/Eye of the Storm	A-Games:E/EyeOfTheStorm/EyeOfTheStorm.Slave
Escape from Colditz DE	E/Escape from Colditz DE	A-Games:F/FluchtAusColditzDe/FluchtAusColditzDe.Slave
Erbe 2: Das Schmutzige Erbe DE	E/Erbe 2 Das Schmutzige Erbe	A-Games:S/SchmutzigeErbeDe/SchmutzigeErbeDe.Slave