Werner Flaschbier	W/Werner Flaschbier	A-Games:F/Flaschbier/Flaschbier.Slave
Werner Flaschbier NoIntro	W/Werner Flaschbier NoIntro	A-Games:F/FlaschbierNoIntro/FlaschbierNoIntro.Slave
World Class Leader Board	W/World Class Leader Board	A-Games:L/LeaderBoardArcadia/LeaderBoardArcadia.Slave
Wacky Darts	W/Wacky Darts	A-Games:W/WackyDarts/WackyDarts.slave
Wacky Races	W/Wacky Races	A-Games:W/WackyRaces/WackyRaces.Slave
Wacus the Detective PL	W/Wacus the Detective PL	A-Games:W/WacusTheDetectivePl/WacusTheDetectivePl.Slave
Walker Crunched	W/Walker Crunched	A-Games:W/WalkerCrunched/WalkerCrunched.Slave
Walker	W/Walker	A-Games:W/WalkerCrunchedNoSpeech/WalkerCrunchedNoSpeech.Slave
Walker Decrunched	W/Walker Decrunched	A-Games:W/WalkerDecrunched/WalkerDecrunched.Slave
Walker	W/Walker 	A-Games:W/WalkerDecrunchedNoSpeech/WalkerDecrunchedNoSpeech.Slave
Wall, The	W/Wall. The	A-Games:W/Wall/Wall.Slave
Wanderer 3D	W/Wanderer 3D	A-Games:W/Wanderer3D/Wanderer3D.Slave
Wanted	W/Wanted	A-Games:W/Wanted/Wanted.Slave
Warhead	W/Warhead	A-Games:W/Warhead/Warhead.Slave
War in Middle Earth	W/War in Middle Earth	A-Games:W/WarInMiddleEarth/WarInMiddleEarth.Slave
War in the Gulf	W/War in the Gulf	A-Games:W/WarInTheGulf/WarInTheGulf.Slave
Warlock's Quest	W/Warlocks Quest	A-Games:W/WarlocksQuest/WarlocksQuest.Slave
Warlock: The Avenger	W/Warlock The Avenger	A-Games:W/WarlockTheAvenger/WarlockTheAvenger.Slave
Warlords	W/Warlords	A-Games:W/Warlords/Warlords.Slave
War Machine	W/War Machine	A-Games:W/WarMachine/WarMachine.Slave
Warm Up	W/Warm Up	A-Games:W/WarmUp/WarmUp.Slave
Warp	W/Warp	A-Games:W/Warp/Warp.slave
War Zone	W/War Zone	A-Games:W/WarZoneCoreDesign/WarzoneCoreDesign.slave
War Zone	W/War Zone 	A-Games:W/WarZoneParadox/WarzoneParadox.Slave
Waterloo	W/Waterloo	A-Games:W/Waterloo/Waterloo.Slave
Waxworks	W/Waxworks	A-Games:W/Waxworks/Waxworks.Slave
Waxworks DE	W/Waxworks DE	A-Games:W/WaxworksDe/WaxworksDe.Slave
Waxworks FR	W/Waxworks FR	A-Games:W/WaxworksFr/WaxworksFr.Slave
Wayne Gretzky Hockey	W/Wayne Gretzky Hockey	A-Games:W/WayneGretzkyHockey/WayneGretzkyHockey.slave
Wayne Gretzky Hockey II	W/Wayne Gretzky Hockey II	A-Games:W/WayneGretzkyHockey2/WayneGretzkyHockey2.Slave
World Class Leader Board	W/World Class Leader Board 	A-Games:W/WCLeaderBoard/WCLeaderBoard.slave
World Class Leader Board DataDisk	W/World Class Leader Board D	A-Games:W/WCLeaderBoard&DataDisks/WCLeaderBoard&DataDisks.slave
Web of Terror	W/Web of Terror	A-Games:W/WebOfTerror/WebOfTerror.slave
Ween: The Prophecy	W/Ween The Prophecy	A-Games:W/WeenTheProphecy/WeenTheProphecy.slave
Ween: The Prophecy DE	W/Ween The Prophecy DE	A-Games:W/WeenTheProphecyDe/WeenTheProphecyDe.slave
Ween: The Prophecy ES	W/Ween The Prophecy ES	A-Games:W/WeenTheProphecyEs/WeenTheProphecyEs.Slave
Ween: The Prophecy FR	W/Ween The Prophecy FR	A-Games:W/WeenTheProphecyFr/WeenTheProphecyFr.slave
Ween: The Prophecy IT	W/Ween The Prophecy IT	A-Games:W/WeenTheProphecyIt/WeenTheProphecyIt.slave
Weird Dreams	W/Weird Dreams	A-Games:W/WeirdDreams/WeirdDreams.Slave
Welltris	W/Welltris	A-Games:W/Welltris/Welltris.slave
Wembley International Soccer	W/Wembley International Socc	A-Games:W/WembleyIntSoccer/WembleyIntSoccer.Slave
Wembley Rugby League	W/Wembley Rugby League	A-Games:W/WembleyRugbyLeague/WembleyRugbyLeague.Slave
Western Games	W/Western Games	A-Games:W/WesternGames/data/WesternGames.slave
Western Games	W/Western Games 	A-Games:W/WesternGames/WesternGames.Slave
West Phaser	W/West Phaser	A-Games:W/WestPhaser/WestPhaser.Slave
Where Time Stood Still	W/Where Time Stood Still	A-Games:W/WhereTimeStoodStill/WhereTimeStoodStill.Slave
Whirligig	W/Whirligig	A-Games:W/Whirligig/Whirligig.Slave
White Death: Battle for Velikiye Luki, November 1942	W/White Death Battle for Vel	A-Games:W/WhiteDeath/WhiteDeath.Slave
Whizz	W/Whizz	A-Games:W/Whizz/Whizz.Slave
Who Framed Roger Rabbit	W/Who Framed Roger Rabbit	A-Games:W/WhoFramedRogerRabbit/WhoFramedRogerRabbit.slave
Wibble World Giddy: Wibble Mania!	W/Wibble World Giddy Wibble	A-Games:W/WibbleWorldGiddy/WibbleWorldGiddy.Slave
Wicked	W/Wicked	A-Games:W/Wicked/Wicked.Slave
Where in Europe is Carmen Sandiego?	W/Where in Europe is Carmen	A-Games:W/WIEuropeIsCarmenSandiego/WIEuropeIsCarmenSandiego.Slave
Wild Cup Soccer	W/Wild Cup Soccer	A-Games:W/WildCupSoccer/WildCupSoccer.Slave
Wild Streets	W/Wild Streets	A-Games:W/WildStreets/WildStreets.slave
Wild West World	W/Wild West World	A-Games:W/WildWestWorld/WildWestWorld.Slave
Wild West World DE	W/Wild West World DE	A-Games:W/WildWestWorldDe/WildWestWorldDe.Slave
Wild Wheels	W/Wild Wheels	A-Games:W/WildWheels/WildWheels.Slave
Window Wizard Files	W/Window Wizard Files	A-Games:W/WindowWizardFiles/WindowWizardFiles.Slave
Window Wizard Image	W/Window Wizard Image	A-Games:W/WindowWizardImage/WindowWizardImage.Slave
Wind Surf Willy	W/Wind Surf Willy	A-Games:W/WindSurfWilly/WindSurfWilly.Slave
Wind Surf Willy FAST	W/Wind Surf Willy FAST	A-Games:W/WindSurfWillyFast/WindSurfWillyFast.slave
Wind Surf Willy FR FAST	W/Wind Surf Willy FR FAST	A-Games:W/WindSurfWillyFastFr/WindSurfWillyFastFr.Slave
Wind Surf Willy FR	W/Wind Surf Willy FR	A-Games:W/WindSurfWillyFr/WindSurfWillyFr.Slave
Windwalker	W/Windwalker	A-Games:W/Windwalker/Windwalker.Slave
Wing Commander	W/Wing Commander	A-Games:W/WingCommander/WingCommander.Slave
Wing Commander DE	W/Wing Commander DE	A-Games:W/WingCommanderDe/WingCommanderDe.Slave
Wings	W/Wings	A-Games:W/Wings/Wings.slave
Wings of Death	W/Wings of Death	A-Games:W/WingsOfDeath/WingsOfDeath.Slave
Wings of Fury	W/Wings of Fury	A-Games:W/WingsOfFury/WingsOfFury.Slave
Winnie the Pooh in the Hundred Acre Wood	W/Winnie the Pooh in the Hun	A-Games:W/WinnieThePooh/WinnieThePooh.Slave
Winning Post	W/Winning Post	A-Games:W/WinningPost/WinningPost.Slave
Winter Camp	W/Winter Camp	A-Games:W/WinterCamp/WinterCamp.Slave
Winter Challenge: World Class Competition	W/Winter Challenge World Cla	A-Games:W/WinterChallenge/WinterChallenge.Slave
Winter Games	W/Winter Games	A-Games:W/WinterGames/WinterGames.Slave
Winter Olympiad 88	W/Winter Olympiad 88	A-Games:W/WinterOlympiad88/WinterOlympiad88.Slave
Winter Olympics	W/Winter Olympics	A-Games:W/WinterOlympics/WinterOlympics.Slave
Winter Supersports 92	W/Winter Supersports 92	A-Games:W/WinterSupersports92/WinterSupersports92.Slave
Winzer	W/Winzer	A-Games:W/Winzer/Winzer.slave
Winzer DE CDTV	W/Winzer DE CDTV	A-Games:W/WinzerCDTVDe/WinzerCDTVDe.Slave
Winzer DE	W/Winzer DE	A-Games:W/WinzerDe/WinzerDe.slave
Wipe Out	W/Wipe Out	A-Games:W/WipeOut/WipeOut.slave
Wisielec PL	W/Wisielec PL	A-Games:W/WisielecPl/WisielecPl.Slave
Where in the USA is Carmen Sandiego?	W/Where in the USA is Carmen	A-Games:W/WITUSAIsCarmenSandiego/WITUSAIsCarmenSandiego.slave
Where in the World is Carmen Sandiego?	W/Where in the World is Carm	A-Games:W/WITWIsCarmenSandiego/WITWIsCarmenSandiego.slave
Wizardry: Bane of the Cosmic Forge	W/Wizardry Bane of the Cosmi	A-Games:W/Wizardry6BaneCosmicForg/Wizardry6BaneCosmicForg.slave
Wizardry: Bane of the Cosmic Forge DE	W/Wizardry Bane of the Co V2	A-Games:W/Wizardry6BaneCosmicForgDe/Wizardry6BaneCosmicForgDe.slave
Wizball	W/Wizball	A-Games:W/Wizball/Wizball.Slave
Wizkid	W/Wizkid	A-Games:W/Wizkid/Wizkid.Slave
Wiz 'n' Liz	W/Wiz n Liz	A-Games:W/WizNLiz/WizNLiz.Slave
Wolfchild	W/Wolfchild	A-Games:W/Wolfchild/Wolfchild.Slave
Wolfpack	W/Wolfpack	A-Games:W/Wolfpack/Wolfpack.Slave
Wonderboy in Monsterland	W/Wonderboy in Monsterland	A-Games:W/WonderboyInMonsterland/WonderboyInMonsterland.Slave
Wonder Dog	W/Wonder Dog	A-Games:W/WonderDog/WonderDog.Slave
Wonderland	W/Wonderland	A-Games:W/Wonderland/Wonderland.Slave
Woody's World	W/Woodys World	A-Games:W/WoodysWorld/WoodysWorld.Slave
World Championship Boxing Manager	W/World Championship Boxing	A-Games:W/WorldChampBoxingManager/WorldChampBoxingManager.Slave
World Championship Soccer WorldChampSoccer	W/World Championship Soccer	A-Games:W/WorldChampionshipSoccer/WorldChampSoccer.Slave
World Circuit	W/World Circuit	A-Games:W/WorldCircuit/WorldCircuit.Slave
World Class Rugby	W/World Class Rugby	A-Games:W/WorldClassRugby/WorldClassRugby.Slave
World Class Rugby: Five Nations Edition	W/World Class Rugby Five Nat	A-Games:W/WorldClassRugby5Nations/WorldClassRugby5Nations.Slave
World Class Rugby '95	W/World Class Rugby 95	A-Games:W/WorldClassRugby95/WorldClassRugby95.Slave
World Cricket	W/World Cricket	A-Games:W/WorldCricket/WorldCricket.Slave
World Cup 90	W/World Cup 90	A-Games:W/WorldCup90/WorldCup90.Slave
World Darts	W/World Darts	A-Games:W/WorldDarts/WorldDarts.Slave
World Darts	W/World Darts 	A-Games:W/WorldDartsArcadia/WorldDartsArcadia.Slave
World Games	W/World Games	A-Games:W/WorldGames/WorldGames.Slave
World Rugby	W/World Rugby	A-Games:W/WorldRugby/WorldRugby.Slave
World Soccer	W/World Soccer	A-Games:W/WorldSoccer/WorldSoccer.Slave
Worlds of Legend: Son of the Empire	W/Worlds of Legend Son of th	A-Games:W/WorldsOfLegend/WorldsOfLegend.slave
World Tour Golf	W/World Tour Golf	A-Games:W/WorldTourGolf/WorldTourGolf.Slave
World Trophy Soccer	W/World Trophy Soccer	A-Games:W/WorldTrophySoccerArcadia/WorldTrophySoccerArcadia.Slave
Worms 1MB	W/Worms 1MB	A-Games:W/Worms1MB/Worms1MB.Slave
Worms 2MB	W/Worms 2MB	A-Games:W/Worms2MB/Worms2MB.Slave
Wormsigns	W/Wormsigns	A-Games:W/Wormsigns/Wormsigns.Slave
W Potrzasku PL	W/W Potrzasku PL	A-Games:W/WPotrzaskuPl/WPotrzaskuPl.Slave
Wrath of the Demon	W/Wrath of the Demon	A-Games:W/WrathOfTheDemon/WrathOfTheDemon.Slave
Wrath of the Demon CDTV	W/Wrath of the Demon CDTV	A-Games:W/WrathOfTheDemonCDTV/WrathOfTheDemonCDTV.slave
Wreckers	W/Wreckers	A-Games:W/Wreckers/Wreckers.Slave
WWF European Rampage Tour	W/WWF European Rampage Tour	A-Games:W/WWFEuropeanRampageTour/WWFEuropeanRampageTour.Slave
WWF WrestleMania	W/WWF WrestleMania	A-Games:W/WWFWrestleMania/WWFWrestlemania.slave