Cabal	C/Cabal	A-Games:C/Cabal/Cabal.slave
Cabaret Asteroids	C/Cabaret Asteroids	A-Games:C/CabaretAsteroids/CabaretAsteroids.slave
Cabaret Asteroids	C/Cabaret Asteroids 	A-Games:C/CabaretAsteroidsRepacked/CabaretAsteroidsRepacked.slave
Cadaver: The Pay Off	C/Cadaver The Pay Off	A-Games:C/Cadaver&ThePayoff/Cadaver&ThePayoff.slave
Cadaver Demos	C/Cadaver Demos	A-Games:C/CadaverDemos/CadaverDemos.slave
Caesar	C/Caesar	A-Games:C/Caesar/Caesar.Slave
Calephar Image	C/Calephar Image	A-Games:C/CalepharImage/CalepharImage.Slave
California Games	C/California Games	A-Games:C/CaliforniaGames/CaliforniaGames.Slave
California Games II	C/California Games II	A-Games:C/CaliforniaGames2/CaliforniaGames2.slave
Campaign	C/Campaign	A-Games:C/Campaign/Campaign.slave
Campaign DataDisk	C/Campaign DataDisk	A-Games:C/Campaign&DataDisk/Campaign&DataDisk.slave
Campaign II	C/Campaign II	A-Games:C/Campaign2/Campaign2.slave
Cannon Fodder	C/Cannon Fodder	A-Games:C/CannonFodder/CannonFodder.Slave
Cannon Fodder 2	C/Cannon Fodder 2	A-Games:C/CannonFodder2/CannonFodder2.Slave
Cannon Fodder 2 - Alien Levels	C/Cannon Fodder 2 - Alien Le	A-Games:C/CannonFodder2AlienLevels/CannonFodder2AlienLevels.Slave
Cannon Fodder 2 DE	C/Cannon Fodder 2 DE	A-Games:C/CannonFodder2De/CannonFodder2De.Slave
Cannon Fodder 2 FR	C/Cannon Fodder 2 FR	A-Games:C/CannonFodder2Fr/CannonFodder2Fr.Slave
Cannon Fodder DE	C/Cannon Fodder DE	A-Games:C/CannonFodderDe/CannonFodderDe.Slave
Cannon Fodder FR	C/Cannon Fodder FR	A-Games:C/CannonFodderFr/CannonFodderFr.Slave
Cannon Fodder IT	C/Cannon Fodder IT	A-Games:C/CannonFodderIt/CannonFodderIt.Slave
Cannon Fodder: New Campaign	C/Cannon Fodder New Campaign	A-Games:C/CannonFodderNewCampaign/CannonFodderNewCampaign.slave
Cannon Fodder Plus	C/Cannon Fodder Plus	A-Games:C/CannonFodderPlus/CannonFodderPlus.Slave
Cannon Soccer	C/Cannon Soccer	A-Games:C/CannonSoccer/CannonSoccer.Slave
Cap 'n' Carnage	C/Cap n Carnage	A-Games:C/CapNCarnage/CapNCarnage.slave
Capone	C/Capone	A-Games:C/Capone/Capone.Slave
Captain Blood	C/Captain Blood	A-Games:C/CaptainBlood/CaptainBlood.Slave
Captain Blood NTSC	C/Captain Blood NTSC	A-Games:C/CaptainBloodNTSC/CaptainBloodNTSC.Slave
Captain Fizz Meets the Blaster-Trons	C/Captain Fizz Meets the Bla	A-Games:C/CaptainFizz/CaptainFizz.slave
Captain Planet and the Planeteers	C/Captain Planet and the Pla	A-Games:C/CaptainPlanet&Planeteers/CaptainPlanet&Planeteers.Slave
Captive	C/Captive	A-Games:C/Captive/Captive.slave
Carcharodon: White Sharks	C/Carcharodon White Sharks	A-Games:C/Carcharodon/Carcharodon.slave
Cardiaxx	C/Cardiaxx	A-Games:C/CardiaxxElectronicZoo/CardiaxxElectronicZoo.Slave
Cardiaxx	C/Cardiaxx 	A-Games:C/CardiaxxTeam17/CardiaxxTeam17.Slave
Cardinal of the Kremlin, The	C/Cardinal of the Kremlin. T	A-Games:C/CardinalOfTheKremlin/CardinalOfTheKremlin.Slave
Carl Lewis Challenge, The	C/Carl Lewis Challenge. The	A-Games:C/CarlLewisChallenge/CarlLewisChallenge.slave
Carlos	C/Carlos	A-Games:C/Carlos/Carlos.Slave
Carnage	C/Carnage	A-Games:C/Carnage/Carnage.slave
Carrier Command	C/Carrier Command	A-Games:C/CarrierCommand/CarrierCommand.Slave
Carrier Command NoMusic	C/Carrier Command NoMusic	A-Games:C/CarrierCommandNoMusic/CarrierCommandNoMusic.Slave
Carthage	C/Carthage	A-Games:C/Carthage/Carthage.Slave
Carthage NTSC	C/Carthage NTSC	A-Games:C/CarthageNTSC/CarthageNTSC.Slave
Carton Rouge FR	C/Carton Rouge FR	A-Games:C/CartonRougeFr/CartonRougeFr.slave
Carver	C/Carver	A-Games:C/Carver/Carver.Slave
Car-Vup	C/Car-Vup	A-Games:C/CarVup/CarVup.Slave
Castle Kingdoms	C/Castle Kingdoms	A-Games:C/CastleKingdoms/CastleKingdoms.Slave
Castle Master	C/Castle Master	A-Games:C/CastleMaster/CastleMaster.Slave
Castle Master II: The Crypt	C/Castle Master II The Crypt	A-Games:C/CastleMaster2/CastleMaster2.Slave
Castle of Dr. Brain DE	C/Castle of Dr. Brain DE	A-Games:C/CastleOfDrBrainDe/CastleOfDrBrainDe.Slave
Castle of Dr. Brain	C/Castle of Dr. Brain	A-Games:C/CastleOfDrBrainDeMT32/CastleOfDrBrainDeMT32.Slave
Castle of Dr. Brain NTSC	C/Castle of Dr. Brain NTSC	A-Games:C/CastleOfDrBrainNTSC/CastleOfDrBrainNTSC.Slave
Castle of Dr. Brain	C/Castle of Dr. Brain 	A-Games:C/CastleOfDrBrainNTSCMT32/CastleOfDrBrainNTSCMT32.Slave
Castles	C/Castles	A-Games:C/Castles/Castles.slave
Castles DE	C/Castles DE	A-Games:C/CastlesDe/CastlesDe.slave
Castlevania	C/Castlevania	A-Games:C/CastleVania/CastleVania.slave
Castle Warrior	C/Castle Warrior	A-Games:C/CastleWarrior/CastleWarrior.slave
Catch 'Em	C/Catch Em	A-Games:C/CatchEm/CatchEm.slave
Cattivik	C/Cattivik	A-Games:C/Cattivik/Cattivik.Slave
Cavemania	C/Cavemania	A-Games:C/CaveMania/Cavemania.slave
Cavitas	C/Cavitas	A-Games:C/Cavitas/Cavitas.Slave
Cedric and the Lost Sceptre	C/Cedric and the Lost Sceptr	A-Games:C/Cedric/Cedric.Slave
Cedric and the Lost Sceptre FAST	C/Cedric and the Lost Sce V2	A-Games:C/CedricFast/CedricFast.Slave
Celtic Legends	C/Celtic Legends	A-Games:C/CelticLegends/CelticLegends.slave
Centerfold Squares	C/Centerfold Squares	A-Games:C/CentrefoldSquares/CentrefoldSquares.Slave
Centurion: Defender of Rome NTSC	C/Centurion Defender of Rome	A-Games:C/CenturionNTSC/CenturionNTSC.Slave
Century	C/Century	A-Games:C/Century/Century.Slave
Chamber of the Sci-Mutant Priestess NTSC	C/Chamber of the Sci-Mutant	A-Games:C/ChamberSciMutantPrstNTSC/ChamberSciMutantPrstNTSC.slave
Chambers of Shaolin	C/Chambers of Shaolin	A-Games:C/ChambersOfShaolin/ChambersOfShaolin.Slave
Champ, The	C/Champ. The	A-Games:C/Champ/Champ.Slave
Champion Driver	C/Champion Driver	A-Games:C/ChampionDriver/ChampionDriver.Slave
Championship Golf	C/Championship Golf	A-Games:C/ChampionshipGolf/ChampionshipGolf.Slave
Champions of Krynn	C/Champions of Krynn	A-Games:C/ChampionsOfKrynn/ChampionsOfKrynn.Slave
Chaos Engine, The	C/Chaos Engine. The	A-Games:C/ChaosEngine/ChaosEngine.Slave
Chaos Engine 2, The	C/Chaos Engine 2. The	A-Games:C/ChaosEngine2/ChaosEngine2.slave
Chaos Engine, The Demo	C/Chaos Engine. The Demo	A-Games:C/ChaosEngineDemo/ChaosEngineDemo.Slave
Chaos in Andromeda: Eyes of the Eagle	C/Chaos in Andromeda Eyes of	A-Games:C/ChaosInAndromeda/ChaosInAndromeda.Slave
Chaos in Andromeda: Eyes of the Eagle CDTV	C/Chaos in Andromeda Eyes V2	A-Games:C/ChaosInAndromedaCDTV/ChaosInAndromedaCDTV.Slave
Chaos Strikes Back DE Util	C/Chaos Strikes Back DE Util	A-Games:C/ChaosStrikesBack&DeUtil/ChaosStrikesBack.Slave
Chaos Strikes Back Util	C/Chaos Strikes Back Util	A-Games:C/ChaosStrikesBack&EnUtil/ChaosStrikesBack.Slave
Chaos Strikes Back FR Util	C/Chaos Strikes Back FR Util	A-Games:C/ChaosStrikesBack&FrUtil/ChaosStrikesBack.Slave
Charlie J. Cool	C/Charlie J. Cool	A-Games:C/CharlieJCool/CharlieJCool.slave
Chase HQ	C/Chase HQ	A-Games:C/ChaseHQ/ChaseHQ.Slave
Chase HQ II: Special Criminal Investigation	C/Chase HQ II Special Crimin	A-Games:C/ChaseHQ2/ChaseHQ2.slave
Chessmaster 2000, The	C/Chessmaster 2000. The	A-Games:C/Chessmaster2000/Chessmaster2000.Slave
Chess Player 2150	C/Chess Player 2150	A-Games:C/ChessPlayer2150/ChessPlayer2150.Slave
Chess Player 2150	C/Chess Player 2150 	A-Games:C/ChessPlayer2150AA/ChessPlayer2150AA.Slave
Chess Player 2150 DE	C/Chess Player 2150 DE	A-Games:C/ChessPlayer2150De/ChessPlayer2150De.Slave
Chess Player 2150 FR	C/Chess Player 2150 FR	A-Games:C/ChessPlayer2150Fr/ChessPlayer2150Fr.Slave
Chess Simulator	C/Chess Simulator	A-Games:C/ChessSimulator/ChessSimulator.Slave
Chicago 90	C/Chicago 90	A-Games:C/Chicago90/Chicago90.Slave
Chichén Itzá ES	C/Chichen Itza ES	A-Games:C/ChichenItzaEs/ChichenItzaEs.slave
Chip's Challenge	C/Chips Challenge	A-Games:C/ChipsChallenge/ChipsChallenge.Slave
Chip's Challenge NTSC	C/Chips Challenge NTSC	A-Games:C/ChipsChallengeNTSC/ChipsChallengeNTSC.Slave
Christoph Kolumbus DE	C/Christoph Kolumbus DE	A-Games:C/ChristophKolumbusDe/ChristophKolumbusDe.slave
Chrome	C/Chrome	A-Games:C/Chrome/Chrome.Slave
Chronicles of Omega, The	C/Chronicles of Omega. The	A-Games:C/ChroniclesOfOmega/ChroniclesOfOmega.slave
Chrono Quest	C/Chrono Quest	A-Games:C/ChronoQuest/ChronoQuest.Slave
Chrono Quest II	C/Chrono Quest II	A-Games:C/ChronoQuest2/ChronoQuest2.Slave
Chrono Quest DE	C/Chrono Quest DE	A-Games:C/ChronoQuestDe/ChronoQuestDe.Slave
Chubby Gristle	C/Chubby Gristle	A-Games:C/ChubbyGristle/ChubbyGristle.Slave
Chuckie Egg	C/Chuckie Egg	A-Games:C/ChuckieEgg/ChuckieEgg.Slave
Chuckie Egg II	C/Chuckie Egg II	A-Games:C/ChuckieEgg2/ChuckieEgg2.Slave
Chuck Rock	C/Chuck Rock	A-Games:C/ChuckRock/ChuckRock.Slave
Chuck Rock II: Son of Chuck	C/Chuck Rock II Son of Chuck	A-Games:C/ChuckRock2/ChuckRock2.slave
Chuck Yeager's Advanced Flight Trainer 2.0	C/Chuck Yeagers Advanced Fli	A-Games:C/ChuckYeagersAFT2/ChuckYeagersAFT2.Slave
Circus Attractions 1Disk	C/Circus Attractions 1Disk	A-Games:C/CircusAttractions1Disk/CircusAttractions1Disk.Slave
Circus Attractions 2Disk	C/Circus Attractions 2Disk	A-Games:C/CircusAttractions2Disk/CircusAttractions2Disk.Slave
Circus Games	C/Circus Games	A-Games:C/CircusGames/CircusGames.Slave
Cisco Heat	C/Cisco Heat	A-Games:C/CiscoHeat/CiscoHeat.Slave
Citadel	C/Citadel	A-Games:C/Citadel/Citadel.slave
City Defence	C/City Defence	A-Games:C/CityDefence/CityDefence.Slave
Civilization	C/Civilization	A-Games:C/Civilization/Civilization.Slave
Civilization CD	C/Civilization CD	A-Games:C/CivilizationCD/CivilizationCD.Slave
Civilization DE	C/Civilization DE	A-Games:C/CivilizationDe/CivilizationDe.Slave
CJ in the USA	C/CJ in the USA	A-Games:C/CJInTheUSA/CJInTheUSA.Slave
CJ's Elephant Antics	C/CJs Elephant Antics	A-Games:C/CJsElephantAntics/CJsElephantAntics.Slave
Classic Arcadia & Baby Arcadia	C/Classic Arcadia Baby Arcad	A-Games:C/Classic&BabyArcadia/Classic&BabyArcadia.Slave
Classic Board Games	C/Classic Board Games	A-Games:C/ClassicBoardGames/ClassicBoardGames.slave
Classic Pucman	C/Classic Pucman	A-Games:C/ClassicPucman/ClassicPucman.slave
Cliffhanger	C/Cliffhanger	A-Games:C/Cliffhanger/Cliffhanger.slave
Clik Clak	C/Clik Clak	A-Games:C/ClikClak/ClikClak.Slave
Clockwiser	C/Clockwiser	A-Games:C/Clockwiser/Clockwiser.Slave
Cloud Kingdoms	C/Cloud Kingdoms	A-Games:C/CloudKingdoms/CloudKingdoms.slave
Clown-O-Mania	C/Clown-O-Mania	A-Games:C/ClownOMania/ClownOMania.slave
Clue!, The	C/Clue. The	A-Games:C/Clue/Clue.slave
Cluedo: Master Detective	C/Cluedo Master Detective	A-Games:C/CluedoMasterDetective/CluedoMasterDetective.Slave
Clue: Master Detective NTSC	C/Clue Master Detective NTSC	A-Games:C/ClueMasterDetectiveNTSC/ClueMasterDetectiveNTSC.slave
COALA	C/COALA	A-Games:C/Coala/Coala.slave
Cobra	C/Cobra	A-Games:C/Cobra/Cobra.slave
Code Name: Iceman	C/Code Name Iceman	A-Games:C/CodeNameIceman/CodenameIceman.slave
Cogans Run	C/Cogans Run	A-Games:C/CogansRun/CogansRun.Slave
Colonel's Bequest, The	C/Colonels Bequest. The	A-Games:C/ColonelsBequest/ColonelsBequest.slave
Colonization	C/Colonization	A-Games:C/Colonization/Colonization.Slave
Colony, The	C/Colony. The	A-Games:C/Colony/Colony.Slave
Colorado	C/Colorado	A-Games:C/Colorado/Colorado.Slave
Colorado FAST	C/Colorado FAST	A-Games:C/ColoradoFast/ColoradoFast.Slave
Colorado FR FAST	C/Colorado FR FAST	A-Games:C/ColoradoFastFr/ColoradoFastFr.slave
Colorado FR	C/Colorado FR	A-Games:C/ColoradoFr/ColoradoFr.Slave
Color Buster	C/Color Buster	A-Games:C/ColorBuster/ColorBuster.slave
Coloris	C/Coloris	A-Games:C/Coloris/Coloris.Slave
Colossus Chess X	C/Colossus Chess X	A-Games:C/ColossusChessX/ColossusChessX.Slave
Combat Air Patrol	C/Combat Air Patrol	A-Games:C/CombatAirPatrol/CombatAirPatrol.slave
Combo Racer	C/Combo Racer	A-Games:C/ComboRacer/ComboRacer.Slave
Commando	C/Commando	A-Games:C/Commando/Commando.Slave
Computer Scrabble	C/Computer Scrabble	A-Games:C/ComputerScrabble/ComputerScrabble.Slave
Conan the Cimmerian	C/Conan the Cimmerian	A-Games:C/ConanTheCimmerian/ConanTheCimmerian.Slave
Conflict: Europe	C/Conflict Europe	A-Games:C/ConflictEurope/ConflictEurope.slave
Conflict: Europe FR	C/Conflict Europe FR	A-Games:C/ConflictEuropeFr/ConflictEuropeFr.Slave
Conflict: The Middle East Political Simulator	C/Conflict The Middle East P	A-Games:C/ConflictMiddleEastPolSim/ConflictMiddleEastPolSim.Slave
Conqueror	C/Conqueror	A-Games:C/Conqueror/Conqueror.Slave
Conquests of Camelot	C/Conquests of Camelot	A-Games:C/ConquestsOfCamelot/ConquestsOfCamelot.Slave
Conquests of the Longbow	C/Conquests of the Longbow	A-Games:C/ConquestsOfTheLongbow/ConquestsOfTheLongbow.slave
Conquests of the Longbow	C/Conquests of the Longbow 	A-Games:C/ConquestsOfTheLongbowMT32/ConquestsOfTheLongbowMT32.slave
Continental Circus	C/Continental Circus	A-Games:C/ContinentalCircus/ContinentalCircus.Slave
Cool Croc Twins	C/Cool Croc Twins	A-Games:C/CoolCrocTwins/CoolCrocTwins.Slave
Cool Spot	C/Cool Spot	A-Games:C/CoolSpot/CoolSpot.slave
Cool World	C/Cool World	A-Games:C/CoolWorld/CoolWorld.slave
Corporation Missions 2Disk	C/Corporation Missions 2Disk	A-Games:C/Corporation&Missions2Disk/Corporation&Missions2Disk.Slave
Corporation Missions 3Disk	C/Corporation Missions 3Disk	A-Games:C/Corporation&Missions3Disk/Corporation&Missions3Disk.Slave
Corporation 1Disk	C/Corporation 1Disk	A-Games:C/Corporation1Disk/Corporation1Disk.Slave
Corporation 2Disk	C/Corporation 2Disk	A-Games:C/Corporation2Disk/Corporation2Disk.Slave
Corruption	C/Corruption	A-Games:C/Corruption/Corruption.Slave
Corsarios	C/Corsarios	A-Games:C/Corsarios/Corsarios.Slave
Corx	C/Corx	A-Games:C/Corx/Corx.Slave
Cosmic Bouncer	C/Cosmic Bouncer	A-Games:C/CosmicBouncer/CosmicBouncer.Slave
Cosmic Pirate	C/Cosmic Pirate	A-Games:C/CosmicPirate/CosmicPirate.Slave
Cosmic Relief: Prof. Renegade to the Rescue NTSC	C/Cosmic Relief Prof. Renega	A-Games:C/CosmicReliefNTSC/CosmicReliefNTSC.Slave
Cosmic Spacehead	C/Cosmic Spacehead	A-Games:C/CosmicSpacehead/CosmicSpacehead.slave
Cougar Force	C/Cougar Force	A-Games:C/CougarForce/CougarForce.Slave
Count Duckula	C/Count Duckula	A-Games:C/CountDuckula/CountDuckula.slave
Cover Girl Strip Poker	C/Cover Girl Strip Poker	A-Games:C/CoverGirlStripPoker/CoverGirlStripPoker.slave
Covert Action	C/Covert Action	A-Games:C/CovertAction/CovertAction.Slave
Covert Action DE	C/Covert Action DE	A-Games:C/CovertActionDe/CovertActionDe.Slave
Crack	C/Crack	A-Games:C/Crack/Crack.Slave
Crack Down	C/Crack Down	A-Games:C/Crackdown/Crackdown.slave
Crash Garrett NTSC	C/Crash Garrett NTSC	A-Games:C/CrashGarrettNTSC/CrashGarrettNTSC.Slave
Crazy Cars	C/Crazy Cars	A-Games:C/CrazyCars/CrazyCars.Slave
Crazy Cars II	C/Crazy Cars II	A-Games:C/CrazyCars2/CrazyCars2.Slave
Crazy Cars III	C/Crazy Cars III	A-Games:C/CrazyCars3/CrazyCars3.slave
Crazy Cars III NoIntro	C/Crazy Cars III NoIntro	A-Games:C/CrazyCars3NoIntro/CrazyCars3NoIntro.slave
Crazy Seasons	C/Crazy Seasons	A-Games:C/CrazySeasons/CrazySeasons.Slave
Crazy Shot	C/Crazy Shot	A-Games:C/CrazyShot/CrazyShot.Slave
Crazy Sue	C/Crazy Sue	A-Games:C/CrazySue/CrazySue.Slave
Crazy Sue ...Goes On	C/Crazy Sue ...Goes On	A-Games:C/CrazySueGoesOn/CrazySueGoesOn.Slave
Creature	C/Creature	A-Games:C/Creature/Creature.Slave
Creatures	C/Creatures	A-Games:C/Creatures/Creatures.Slave
Crime City	C/Crime City	A-Games:C/CrimeCity/CrimeCity.slave
Crime City DE	C/Crime City DE	A-Games:C/CrimeCityDe/CrimeCityDe.slave
Crime Does Not Pay	C/Crime Does Not Pay	A-Games:C/CrimeDoesNotPay/CrimeDoesNotPay.Slave
Crime Wave	C/Crime Wave	A-Games:C/CrimeWave/CrimeWave.slave
Croak!	C/Croak	A-Games:C/Croak/Croak.Slave
Croak 2	C/Croak 2	A-Games:C/Croak2/Croak2.Slave
Croisière Pour Un Cadavre FR	C/Croisiere Pour Un Cadavre	A-Games:C/CroisierePourUnCadavreFr/CroisierePourUnCadavreFr.slave
Crossbow: The Legend of William Tell	C/Crossbow The Legend of Wil	A-Games:C/CrossbowLegendWilliamTell/CrossbowLegendWilliamTell.Slave
CrossCheck	C/CrossCheck	A-Games:C/CrossCheck/CrossCheck.slave
Cruise for a Corpse	C/Cruise for a Corpse	A-Games:C/CruiseForACorpse/CruiseForACorpse.slave
Cruise for a Corpse DE	C/Cruise for a Corpse DE	A-Games:C/CruiseForACorpseDe/CruiseForACorpseDe.slave
Cruise for a Corpse ES	C/Cruise for a Corpse ES	A-Games:C/CruiseForACorpseEs/CruiseForACorpseEs.slave
Cruise for a Corpse IT	C/Cruise for a Corpse IT	A-Games:C/CruiseForACorpseIt/CruiseForACorpseIt.slave
Cruncher Factory	C/Cruncher Factory	A-Games:C/CruncherFactory/CruncherFactory.Slave
Crystal Dragon	C/Crystal Dragon	A-Games:C/CrystalDragon/CrystalDragon.Slave
Crystal Dragon DE	C/Crystal Dragon DE	A-Games:C/CrystalDragonDe/CrystalDragonDe.slave
Crystal Hammer	C/Crystal Hammer	A-Games:C/CrystalHammerV1/CrystalHammerV1.slave
Crystal Hammer	C/Crystal Hammer 	A-Games:C/CrystalHammerV2/CrystalHammerV2.slave
Crystal Kingdom Dizzy	C/Crystal Kingdom Dizzy	A-Games:C/CrystalKingdomDizzy/CrystalKingdomDizzy.slave
Crystal Palace	C/Crystal Palace	A-Games:C/CrystalPalace/CrystalPalace.slave
Crystals of Arborea	C/Crystals of Arborea	A-Games:C/CrystalsOfArborea/CrystalsOfArborea.Slave
Crystals of Arborea DE	C/Crystals of Arborea DE	A-Games:C/CrystalsOfArboreaDe/CrystalsOfArboreaDe.Slave
Crystals of Arborea DE FAST	C/Crystals of Arborea DE FAS	A-Games:C/CrystalsOfArboreaDeFast/CrystalsOfArboreaDeFast.Slave
Crystals of Arborea FAST	C/Crystals of Arborea FAST	A-Games:C/CrystalsOfArboreaFast/CrystalsOfArboreaFast.Slave
Crystals of Arborea FR	C/Crystals of Arborea FR	A-Games:C/CrystalsOfArboreaFr/CrystalsOfArboreaFr.Slave
Crystals of Arborea FR FAST	C/Crystals of Arborea FR FAS	A-Games:C/CrystalsOfArboreaFrFast/CrystalsOfArboreaFrFast.Slave
Cubix	C/Cubix	A-Games:C/Cubix/Cubix.Slave
Cubulus	C/Cubulus	A-Games:C/Cubulus/Cubulus.Slave
Curse of Enchantia	C/Curse of Enchantia	A-Games:C/CurseOfEnchantia/CurseOfEnchantia.Slave
Curse of RA, The	C/Curse of RA. The	A-Games:C/CurseOfRa/CurseOfRa.slave
Curse of RA, The CDTV	C/Curse of RA. The CDTV	A-Games:C/CurseOfRaCDTV/CurseOfRaCDTV.Slave
Curse of the Azure Bonds	C/Curse of the Azure Bonds	A-Games:C/CurseOfTheAzureBonds/CurseOfTheAzureBonds.Slave
Custodian	C/Custodian	A-Games:C/Custodian/Custodian.Slave
Cyber Assault	C/Cyber Assault	A-Games:C/CyberAssault/CyberAssault.Slave
Cyberball	C/Cyberball	A-Games:C/Cyberball/Cyberball.slave
Cyberblast	C/Cyberblast	A-Games:C/Cyberblast/Cyberblast.slave
Cybercon III	C/Cybercon III	A-Games:C/Cybercon3/Cybercon3.Slave
Cyber Cop	C/Cyber Cop	A-Games:C/CyberCop/CyberCop.slave
Cyber Empires	C/Cyber Empires	A-Games:C/CyberEmpires/CyberEmpires.Slave
Cyber Games	C/Cyber Games	A-Games:C/CyberGames/CyberGames.Slave
Cybernetix	C/Cybernetix	A-Games:C/Cybernetix/Cybernetix.Slave
Cybernoid: The Fighting Machine	C/Cybernoid The Fighting Mac	A-Games:C/Cybernoid/Cybernoid.Slave
Cybernoid II: The Revenge	C/Cybernoid II The Revenge	A-Games:C/Cybernoid2/Cybernoid2.Slave
Cyberpunks	C/Cyberpunks	A-Games:C/Cyberpunks/Cyberpunks.Slave
Cyber World	C/Cyber World	A-Games:C/CyberWorld/CyberWorld.Slave
Cyberzerk	C/Cyberzerk	A-Games:C/Cyberzerk/Cyberzerk.slave
Cycles, The: International Grand Prix Racing	C/Cycles. The International	A-Games:C/Cycles/Cycles.Slave
Cygnus 8	C/Cygnus 8	A-Games:C/Cygnus8/Cygnus8.Slave
Citadel PL	C/Citadel PL	A-Games:C/CytadelaPl/CytadelaPl.slave
Cytron	C/Cytron	A-Games:C/Cytron/Cytron.slave
Cytron NTSC	C/Cytron NTSC	A-Games:C/CytronNTSC/CytronNTSC.slave
Captain Dynamo	C/Captain Dynamo	A-Games:D/Dynamo/Dynamo.slave
Celica GT Rally	C/Celica GT Rally	A-Games:T/ToyotaCelicaGTRally/ToyotaCelicaGTRally.Slave