K240 1MB	K/K240 1MB	A-Games:K/K2401MB/K2401MB.Slave
K240 512KB	K/K240 512KB	A-Games:K/K240512KB/K240512KB.slave
Kaiser DE	K/Kaiser DE	A-Games:K/KaiserDe/KaiserDe.Slave
Kajko i Kokosz	K/Kajko i Kokosz	A-Games:K/KajkoIKokosz/KajkoIKokosz.slave
Kajko i Kokosz PL	K/Kajko i Kokosz PL	A-Games:K/KajkoIKokoszPl/KajkoIKokoszPl.Slave
Kalas Puffs Expressen SE 1MB	K/Kalas Puffs Expressen SE 1	A-Games:K/KalasPuffExpressenSe1MB/KalasPuffExpressenSe1MB.slave
Kalas Puffs Expressen SE 512KB	K/Kalas Puffs Expressen SE 5	A-Games:K/KalasPuffExpressenSe512KB/KalasPuffExpressenSe512KB.slave
Kamikaze	K/Kamikaze	A-Games:K/Kamikaze/Kamikaze.Slave
Karate Kid Part II, The	K/Karate Kid Part II. The	A-Games:K/KarateKid2/KarateKid2.slave
Karate King	K/Karate King	A-Games:K/KarateKing&CityDefence/KarateKing&CityDefence.Slave
Karting Grand Prix	K/Karting Grand Prix	A-Games:K/KartingGrandPrix/KartingGrandPrix.Slave
Katakis 1Disk	K/Katakis 1Disk	A-Games:K/Katakis1Disk/Katakis1Disk.Slave
Katakis 2Disk	K/Katakis 2Disk	A-Games:K/Katakis2Disk/Katakis2Disk.Slave
Keef the Thief	K/Keef the Thief	A-Games:K/KeefTheThief/KeefTheThief.Slave
Kelly X	K/Kelly X	A-Games:K/KellyX/KellyX.slave
Kennedy Approach	K/Kennedy Approach	A-Games:K/KennedyApproach/KennedyApproach.slave
Keys to Maramon, The	K/Keys to Maramon. The	A-Games:K/KeysToMaramon/KeysToMaramon.Slave
KGB	K/KGB	A-Games:K/KGB/KGB.Slave
KGB DE	K/KGB DE	A-Games:K/KGBDe/KGBDe.Slave
KGB FR	K/KGB FR	A-Games:K/KGBFr/KGBFr.Slave
Khalaan	K/Khalaan	A-Games:K/Khalaan/Khalaan.Slave
Kick Off	K/Kick Off	A-Games:K/KickOff/KickOff.Slave
Kick Off ExtraTime 1Disk	K/Kick Off ExtraTime 1Disk	A-Games:K/KickOff&ExtraTime1Disk/KickOff&ExtraTime1Disk.Slave
Kick Off ExtraTime 2Disk	K/Kick Off ExtraTime 2Disk	A-Games:K/KickOff&ExtraTime2Disk/KickOff&ExtraTime2Disk.Slave
Kick Off 2	K/Kick Off 2	A-Games:K/KickOff2/KickOff2.slave
Kick Off 2	K/Kick Off 2 	A-Games:K/KickOff216/KickOff216.slave
Kick Off 2 CV	K/Kick Off 2 CV	A-Games:K/KickOff2CV/KickOff2CV.slave
Kick Off 2 DE	K/Kick Off 2 DE	A-Games:K/KickOff2De/KickOff2De.slave
Kick Off 2 ES	K/Kick Off 2 ES	A-Games:K/KickOff2Es/KickOff2Es.slave
Kick Off 2: The Final Whistle	K/Kick Off 2 The Final Whist	A-Games:K/KickOff2FinalWhistle/KickOff2FinalWhistle.slave
Kick Off 2: The Final Whistle CV	K/Kick Off 2 The Final Wh V2	A-Games:K/KickOff2FinalWhistleCV/KickOff2FinalWhistleCV.slave
Kick Off 2: The Final Whistle KickOff2FW DE	K/Kick Off 2 The Final Wh V3	A-Games:K/KickOff2FinalWhistleDe/KickOff2FWDe.Slave
Kick Off 2 FR	K/Kick Off 2 FR	A-Games:K/KickOff2Fr/KickOff2Fr.slave
Kick Off 2 IT	K/Kick Off 2 IT	A-Games:K/KickOff2It/KickOff2It.slave
Kick Off 2	K/Kick Off 2  	A-Games:K/KickOff2PlusWC90/KickOff2PlusWC90.slave
Kick Off 2 DE	K/Kick Off 2 DE 	A-Games:K/KickOff2PlusWC90De/KickOff2PlusWC90De.slave
Kick Off 2 FR	K/Kick Off 2 FR 	A-Games:K/KickOff2PlusWC90Fr/KickOff2PlusWC90Fr.slave
Kick Off 2 IT	K/Kick Off 2 IT 	A-Games:K/KickOff2PlusWC90It/KickOff2PlusWC90It.slave
Kick Off 2: Return to Europe	K/Kick Off 2 Return to Europ	A-Games:K/KickOff2ReturnToEurope/KickOff2ReturnToEurope.slave
Kick Off 3	K/Kick Off 3	A-Games:K/KickOff3/KickOff3.Slave
Kick Off 3: European Challenge	K/Kick Off 3 European Challe	A-Games:K/KickOff3EuroChallenge/KickOff3EuroChallenge.Slave
Kick Off 96	K/Kick Off 96	A-Games:K/KickOff96/KickOff96.slave
Kid Chaos	K/Kid Chaos	A-Games:K/KidChaos/KidChaos.slave
Kid Gloves	K/Kid Gloves	A-Games:K/KidGloves/KidGloves.Slave
Kid Gloves II	K/Kid Gloves II	A-Games:K/KidGloves2/KidGloves2.Slave
Kikstart II	K/Kikstart II	A-Games:K/Kikstart2/Kikstart2.Slave
Kikugi	K/Kikugi	A-Games:K/Kikugi/Kikugi.Slave
Killerball	K/Killerball	A-Games:K/Killerball/Killerball.Slave
Killing Cloud, The	K/Killing Cloud. The	A-Games:K/KillingCloud/KillingCloud.Slave
Killing Game Show, The	K/Killing Game Show. The	A-Games:K/KillingGameShow/KillingGameShow.Slave
Killing Machine	K/Killing Machine	A-Games:K/KillingMachine/KillingMachine.Slave
Kingmaker: The Quest for the Crown	K/Kingmaker The Quest for th	A-Games:K/KingmakerQuestForTheCrown/KingmakerQuestForTheCrown.Slave
King of Chicago, The	K/King of Chicago. The	A-Games:K/KingOfChicago/KingOfChicago.Slave
Kingpin: Arcade Sports Series Bowling	K/Kingpin Arcade Sports Seri	A-Games:K/Kingpin/Kingpin.Slave
Kingpin: Arcade Sports Series Bowling 1MB	K/Kingpin Arcade Sports S V2	A-Games:K/Kingpin1Mb/Kingpin1Mb.Slave
Kingpin: Arcade Sports Bowling Demo	K/Kingpin Arcade Sports Bowl	A-Games:K/KingpinDemo/KingpinDemo.Slave
King's Quest	K/Kings Quest	A-Games:K/KingsQuest/KingsQuest.slave
King's Quest II	K/Kings Quest II	A-Games:K/KingsQuest2/KingsQuest2.Slave
King's Quest III: To Heir is Human	K/Kings Quest III To Heir is	A-Games:K/KingsQuest3/KingsQuest3.Slave
King's Quest IV	K/Kings Quest IV	A-Games:K/KingsQuest4/KingsQuest4.slave
King's Quest V	K/Kings Quest V	A-Games:K/KingsQuest5/KingsQuest5.slave
King's Quest V DE	K/Kings Quest V DE	A-Games:K/KingsQuest5De/KingsQuest5De.slave
King's Quest V IT	K/Kings Quest V IT	A-Games:K/KingsQuest5It/KingsQuest5It.slave
King's Quest VI	K/Kings Quest VI	A-Games:K/KingsQuest6/KingsQuest6.slave
King's Quest VI DE	K/Kings Quest VI DE	A-Games:K/KingsQuest6De/KingsQuest6De.slave
King's Quest VI FR	K/Kings Quest VI FR	A-Games:K/KingsQuest6Fr/KingsQuest6Fr.slave
King's Quest: Quest for the Crown	K/Kings Quest Quest for the	A-Games:K/KingsQuestEnhanced/KingsQuestEnhanced.slave
Kiro's Quest	K/Kiros Quest	A-Games:K/KirosQuest/KirosQuest.slave
Klax	K/Klax	A-Games:K/Klax/Klax.Slave
Knight Force	K/Knight Force	A-Games:K/KnightForce/KnightForce.Slave
Knightmare	K/Knightmare	A-Games:K/Knightmare/Knightmare.slave
Knight Orc	K/Knight Orc	A-Games:K/KnightOrc/KnightOrc.Slave
Knights of the Crystallion	K/Knights of the Crystallion	A-Games:K/KnightsOfTheCrystallion/KnightsOfTheCrystallion.slave
Knights of the Crystallion KnightsOfCrystallion DE	K/Knights of the Crystall V2	A-Games:K/KnightsOfTheCrystallionDe/KnightsOfCrystallionDe.Slave
Knights of the Sky	K/Knights of the Sky	A-Games:K/KnightsOfTheSky/KnightsOfTheSky.Slave
Kristal, The	K/Kristal. The	A-Games:K/Kristal/Kristal.Slave
Kristal, The DE	K/Kristal. The DE	A-Games:K/KristalDe/KristalDe.Slave
Kristal, The NTSC	K/Kristal. The NTSC	A-Games:K/KristalNTSC/KristalNTSC.Slave
Krusty's Super Fun House	K/Krustys Super Fun House	A-Games:K/KrustysSuperFunHouse/KrustysSuperFunHouse.Slave
Krypton Egg	K/Krypton Egg	A-Games:K/KryptonEgg/KryptonEgg.Slave
Kult	K/Kult	A-Games:K/Kult/Kult.slave
Kwasimodo	K/Kwasimodo	A-Games:K/Kwasimodo/Kwasimodo.Slave
Kwik Snax	K/Kwik Snax	A-Games:K/KwikSnax/KwikSnax.slave
King's Table: The Legend of Ragnarok	K/Kings Table The Legend of	A-Games:L/LegendOfRagnarok/LegendOfRagnarok.slave