Kalas Puffs Expressen SE 512KB	K/Kalas Puffs Expressen SE 5	A-Games:K/KalasPuffExpressenSe512KB/KalasPuffExpressenSe512KB.slave
Kamikaze	K/Kamikaze	A-Games:K/Kamikaze/Kamikaze.Slave
Karate Kid Part II, The	K/Karate Kid Part II. The	A-Games:K/KarateKid2/KarateKid2.slave
Katakis 1Disk	K/Katakis 1Disk	A-Games:K/Katakis1Disk/Katakis1Disk.Slave
Katakis 2Disk	K/Katakis 2Disk	A-Games:K/Katakis2Disk/Katakis2Disk.Slave
Kennedy Approach	K/Kennedy Approach	A-Games:K/KennedyApproach/KennedyApproach.slave
Keys to Maramon, The	K/Keys to Maramon. The	A-Games:K/KeysToMaramon/KeysToMaramon.Slave
Kick Off	K/Kick Off	A-Games:K/KickOff/KickOff.Slave
Kick Off ExtraTime 1Disk	K/Kick Off ExtraTime 1Disk	A-Games:K/KickOff&ExtraTime1Disk/KickOff&ExtraTime1Disk.Slave
Kick Off ExtraTime 2Disk	K/Kick Off ExtraTime 2Disk	A-Games:K/KickOff&ExtraTime2Disk/KickOff&ExtraTime2Disk.Slave
Kid Gloves	K/Kid Gloves	A-Games:K/KidGloves/KidGloves.Slave
Kid Gloves II	K/Kid Gloves II	A-Games:K/KidGloves2/KidGloves2.Slave
Kikstart II	K/Kikstart II	A-Games:K/Kikstart2/Kikstart2.Slave
Killing Cloud, The	K/Killing Cloud. The	A-Games:K/KillingCloud/KillingCloud.Slave
Killing Game Show, The	K/Killing Game Show. The	A-Games:K/KillingGameShow/KillingGameShow.Slave
Kiro's Quest	K/Kiros Quest	A-Games:K/KirosQuest/KirosQuest.slave
Klax	K/Klax	A-Games:K/Klax/Klax.Slave
Kristal, The	K/Kristal. The	A-Games:K/Kristal/Kristal.Slave
Kristal, The DE	K/Kristal. The DE	A-Games:K/KristalDe/KristalDe.Slave
Kristal, The NTSC	K/Kristal. The NTSC	A-Games:K/KristalNTSC/KristalNTSC.Slave
Krusty's Super Fun House	K/Krustys Super Fun House	A-Games:K/KrustysSuperFunHouse/KrustysSuperFunHouse.Slave
Krypton Egg	K/Krypton Egg	A-Games:K/KryptonEgg/KryptonEgg.Slave
Kwik Snax	K/Kwik Snax	A-Games:K/KwikSnax/KwikSnax.slave