Race Drivin'	R/Race Drivin	A-Games:R/RaceDrivin/RaceDrivin.slave
Race Drivin' NoIntro	R/Race Drivin NoIntro	A-Games:R/RaceDrivinNoIntro/RaceDrivinNoIntro.slave
Rackney's Island	R/Rackneys Island	A-Games:R/RackneysIsland/RackneysIsland.Slave
Rainbow Islands	R/Rainbow Islands	A-Games:R/RainbowIslands/RainbowIslands.slave
Rainbow Warrior	R/Rainbow Warrior	A-Games:R/RainbowWarrior/RainbowWarrior.Slave
Rally Cross Challenge	R/Rally Cross Challenge	A-Games:R/RallyCrossChallenge/RallyCrossChallenge.Slave
Rambo III	R/Rambo III	A-Games:R/Rambo3/Rambo3.slave
Rambo III NTSC	R/Rambo III NTSC	A-Games:R/Rambo3NTSC/Rambo3NTSC.slave
Rampage	R/Rampage	A-Games:R/Rampage/Rampage.slave
Rat Trap	R/Rat Trap	A-Games:R/RatTrap/RatTrap.Slave
R.B.I. 2 Baseball	R/R.B.I. 2 Baseball	A-Games:R/RBI2Baseball/RBI2Baseball.Slave
Real Ghostbusters, The	R/Real Ghostbusters. The	A-Games:R/RealGhostbusters/RealGhostbusters.Slave
Realms	R/Realms	A-Games:R/Realms/Realms.Slave
Real Popeye, The	R/Real Popeye. The	A-Games:R/RealPopeye/RealPopeye.Slave
Rebellion	R/Rebellion	A-Games:R/Rebellion/Rebellion.slave
Red Heat	R/Red Heat	A-Games:R/RedHeat/RedHeat.slave
Reflexity: Pinball Challenge	R/Reflexity Pinball Challeng	A-Games:R/Reflexity/Reflexity.Slave
Renegade	R/Renegade	A-Games:R/Renegade/Renegade.slave
Renegades Deluxe Editor	R/Renegades Deluxe Editor	A-Games:R/Renegades/RenegadesEditor.Slave
Renegades Deluxe	R/Renegades Deluxe	A-Games:R/Renegades/Renegades.Slave
Resolution 101	R/Resolution 101	A-Games:R/Resolution101/Resolution101.Slave
Return to Genesis	R/Return to Genesis	A-Games:R/ReturnToGenesis/ReturnToGenesis.Slave
Revelation!	R/Revelation	A-Games:R/Revelation/Revelation.Slave
Revenge of Defender	R/Revenge of Defender	A-Games:R/RevengeOfDefender/RevengeOfDefender.slave
Revenge of the Mutant Camels	R/Revenge of the Mutant Came	A-Games:R/RevengeOfMutantCamels/RevengeOfMutantCamels.Slave
Revenge of the Mutant Camels II	R/Revenge of the Mutant C V2	A-Games:R/RevengeOfMutantCamels2/RevengeOfMutantCamels2.slave
Revenge of the Mutant Camels NTSC	R/Revenge of the Mutant C V3	A-Games:R/RevengeOfMutantCamelsNTSC/RevengeOfMutantCamelsNTSC.Slave
Rick Dangerous	R/Rick Dangerous	A-Games:R/RickDangerous/RickDangerous.Slave
Rick Dangerous II	R/Rick Dangerous II	A-Games:R/RickDangerous2/RickDangerous2.slave
Rick Dangerous II	R/Rick Dangerous II 	A-Games:R/RickDangerous25/RickDangerous25.Slave
Risky Woods	R/Risky Woods	A-Games:R/RiskyWoods/RiskyWoods.Slave
RoadBlasters	R/RoadBlasters	A-Games:R/RoadBlasters/RoadBlasters.Slave
Roadwars	R/Roadwars	A-Games:R/RoadWars/RoadWars.Slave
Robbeary	R/Robbeary	A-Games:R/Robbeary/Robbeary.Slave
Robin Hood: Legend Quest	R/Robin Hood Legend Quest	A-Games:R/RobinHoodLegendQuest/RobinHoodLegendQuest.slave
RoboCop	R/RoboCop	A-Games:R/RoboCop/RoboCop.Slave
RoboCop 2	R/RoboCop 2	A-Games:R/RoboCop2/RoboCop2.Slave
Robotnic	R/Robotnic	A-Games:R/Robotnic/Robotnic.Slave
Rockford	R/Rockford	A-Games:R/Rockford/Rockford.slave
Rodland	R/Rodland	A-Games:R/RodLand/RodLand.Slave
Rody & Mastico II FR	R/Rody Mastico II FR	A-Games:R/Rody&Mastico2Fr/Rody&Mastico2Fr.Slave
Rody & Mastico III FR	R/Rody Mastico III FR	A-Games:R/Rody&Mastico3Fr/Rody&Mastico3Fr.Slave
Rody Noël FR	R/Rody Noel FR	A-Games:R/Rody&Mastico4RodyNoelFr/Rody&Mastico4RodyNoelFr.Slave
Rody V FR	R/Rody V FR	A-Games:R/Rody&Mastico5Fr/Rody&Mastico5Fr.Slave
Rody VI FR	R/Rody VI FR	A-Games:R/Rody&Mastico6Fr/Rody&Mastico6Fr.Slave
Rogue Trooper	R/Rogue Trooper	A-Games:R/RogueTrooper/RogueTrooper.Slave
RollerCoaster Rumbler	R/RollerCoaster Rumbler	A-Games:R/RollerCoasterRumbler/RollerCoasterRumbler.Slave
Roll or Die	R/Roll or Die	A-Games:R/RollOrDie/RollOrDie.slave
Rome AD92: The Pathway To Power	R/Rome AD92 The Pathway To P	A-Games:R/RomeAD92/RomeAD92.Slave
Rotor	R/Rotor	A-Games:R/Rotor/Rotor.slave
Rotox	R/Rotox	A-Games:R/Rotox/Rotox.slave
Round the Bend!	R/Round the Bend	A-Games:R/RoundTheBend/RoundTheBend.Slave
R-Type	R/R-Type	A-Games:R/RType/RType.Slave
R-Type II	R/R-Type II	A-Games:R/RType2/RType2.Slave
Ruff and Reddy in the Space Adventure	R/Ruff and Reddy in the Spac	A-Games:R/Ruff&ReddySpaceAdventure/Ruff&ReddySpaceAdventure.slave
Rugby: The World Cup	R/Rugby The World Cup	A-Games:R/RugbyTheWorldCup/RugbyTheWorldCup.Slave
Rugby: The World Cup RugbyTheWorldCupEarlyBld	R/Rugby The World Cup RugbyT	A-Games:R/RugbyTheWorldCupEarlyBuild/RugbyTheWorldCupEarlyBld.Slave
Running Man, The	R/Running Man. The	A-Games:R/RunningMan/RunningMan.slave
Run the Gauntlet	R/Run the Gauntlet	A-Games:R/RunTheGauntlet/RunTheGauntlet.Slave
Rushhour	R/Rushhour	A-Games:R/Rushhour/Rushhour.Slave
RVF Honda	R/RVF Honda	A-Games:R/RVFHonda/RVFHonda.slave